brave|храбрый, смелый
disarm|обезоруживать, разоружать
plastic|пластмасса, пластичный
holding|удерживание, держащий
pitcher|подающий
surname|фамилия
seaman|моряк
compete|состязаться, конкурировать
cripple|калечить, уродовать
deputy|депутат, делегат
slope|склон, наклон, гора для катания
event|событие
ribbon|лента
jew|Еврей
joke|шутка, шутить
cage|клетка, кабина
mania|мания
heed|внимание, слушать внимательно
jet|струя
brigade|бригада
timber|бревно
asset|имущество
brawl|уличный скандал
marquis|Маркиз
told|рассказал, сообщил
heel|пятка, каблук
answer|ответ, отвечать
sleeve|рукав
regard|взгляд, внимание, смотреть, считать
meet|встречать, знакомиться
armies|Армии
dawn|рассвет, светать
stadium|стадион
quality|качество
pitched|Переданный
cafe|кафе
forbid|запрещать
steady|прочный
tome|Том
tomb|могила, гробница
rev|оборот
horns|Рожки
moral|нравственный
rex|Рекс
vastly|значительно
truck|грузовик
willow|ива
parted|Разделенный
drawing|протаскивание, вытягивание, рисование, чертеж
relief|облегчение, утешение
drip|капать
renamed|Переименованный
meek|кроткий
advised|Рекомендованный
times|раз
chaise|Фаэтон
guard|охрана, стража
lettuce|салат
fudge|глупость, чушь
grew|рос
debts|долги
grey|серый
ropes|Веревки
ignore|игнорировать
pity|жалость
enjoyed|получил удовольствие
tone|стиль, характер
myrtle|Мирт
illegal|нелегальный
crouch|притаиться
suffer|страдать
cutting|сокращение, урезание
join|соединяться
smiles|Улыбки
taking|овладение
labor|Рабочая сила
ports|порты
red|красный
days|дни
legend|легенда
library|библиотека
advice|cовет
zone|зона
britain|Британия
suspend|приостанавливать
fancy|воображать, представлять себе
unions|союзы
basin|бассейн
invader|захватчик
basis|основа, основание
forbes|Форбес
drop|капля, падать, ронять
tool|инструмент
infant|младенец
took|брал
echo|эхо, отголосок
hiking|пеший поход
afar|далеко, вдали
invalid|недействительный
updated|Обновленный
basic|основной
jar|ссора
plaster|пластырь, штукатурка, штукатурить
derived|Полученный
jan|Январь
doubly|вдвое
jam|варенье, джем
motion|движение
guilt|вина, виновность
salvage|спасать
wording|редакция, форма выражения, формулировка
verge|грань, край
unrest|беспокойство
spat|размолвка, звонкий удар
station|станция, место, размещать
pumpkin|тыква
barbed|колючий, ядовитый
leisure|досуг
resist|сопротивляться
double|двойной, на двоих
heir|наследник
timid|робкий, застенчивый
jaw|челюсть
much|много
country|страна
mislead|вводить в заблуждение
toffee|ириска
speech|речь
tremble|дрожать, дрожь
weary|усталый, утомительный, утомлять, устать, потерять терпение
column|графа, отдел
garret|мансарда, чердак
brass|установить
update|Модернизация
raw|сырой
prophet|пророк
grab|внезапно схватывать
ray|луч
connect|соединять
horse|лошадь
wheeled|Колесный
rat|крыса
disturb|нарушать, беспокоить
twin|двойной, двойник, близнец
dime|дайм
knelt|стоял на коленях
twit|упрек, насмешка
stately|величавый, величественный
lament|сетование, жалоба
twig|веточка, прутик
fuel|топливо, горючее
hinder|препятствовать, мешать
gram|грамм
chris|Крис
alike|похожий
spends|проводит
axis|ось
diver|водолаз
cellar|подвал, винный погреб
peach|персик
brittle|хрупкий, ломкий
gray|Серый
biscuit|сухое печенье
torn|оборванный
wicked|злой
dived|Нырнул
hello|привет
dine|обедать
entire|полный, совершенный
wooden|деревянный
which|который
rag|тряпка, лохмотья
flush|краснеть
ran|бежал, убежавший
ram|баран
female|женщина, самка
tore|рвал
royal|королевский
anyone|любой, всякий
peace|мир
brows|Брови
brown|коричневый
exhaust|исчерпывать, истощать, выхлоп
sunrise|восход солнца
lowered|Пониженный
whirl|вихрь
jobs|работы
lower|нижний, снижать, опускать
riddle|загадка
hasty|поспешный, необдуманный
dagger|кинжал
amateur|любитель
rock|скала
rode|ехать
haste|спешка
help|помощь, помогать
village|деревня
zeal|усердие, рвение
bones|кости
rpm|Оборот в минуту
border|граница
purge|чистка
alight|выходить, спускаться
element|элемент, стихия
elect|выбирать e
support|поддерживать, опора, поддержка
rot|вздор, нелепость
ron|Рон
wren|Крапивник
menu|меню
peeves|Обиды
job|работа
resign|уходить в отставку
assured|уверенный, застрахованный
health|здоровье
row|грести
scent|запах, духи, след, почуять, нюхать
rob|грабить, обворовывать
hemp|конопля, пенька
suppose|полагать, предполагать
rod|прут, жезл, удочка
regain|достичь
avenue|проспект
weave|ткать, плести
mend|чинить, ремонтировать
scene|действие, картина, сцена
branch|ветвь, отрасль
western|западный
upon|на
burlap|холст, мешковина
roam|бродить, скитаться
binary|Набор из двух предметов
spoons|ложки
embark|садиться на корабль
roar|реветь, орать, хохотать
thorpe|Торп
shawl|платок, шаль
joy|радость
vehicle|транспортное средство
thought|думал, обдуманный , мысль
easily|легко
road|дорога
space|пространство, место, космос
express|экспресс, выражать
villain|злодей, негодяй
brandy|коньяк, бренди
pyjamas|пижама
joe|кофе
reside|жить, проживать
endless|бесконечный
rather|скорее, лучше
painter|художник
trading|торговля
speedy|быстрый, скорый
cranny|скважина, трещина
athlete|спортсмен, атлет
analyse|анализировать, разбирать
melt|таять
joan|Джоан
held|держал
ostrich|страус
fangs|Клыки
foster|воспитывать
hell|черт
toes|Пальцы ноги
helm|руль
spade|лопата, заступ
wailing|Вопящий
drowsy|сонный, дремлющий
recall|припомнить, отозвать
whale|кит
warning|предупреждение
truly|точно, правдиво, истинно, верно
swiftly|быстро
polite|любезный, вежливый
dish|блюдо
single|один, одинокий
monday|понедельник
disk|Диск
pierre|Пирр
entered|поступил
flung|бросал, швырял
mess|беспорядок, путаница
every|каждый
eight|восемь
disc|диск
shave|бриться, бритье, подстригать
jim|Джим
mule|мул, тупица, гибрид, туфля без задников
whine|визг, скулить
muscles|Мускулы
pray|молить
sleepy|сонный, сонливый
writer|писатель
dirt|грязь
younger|моложе
wrap|завертывать, шаль, плед, обертка
joint|совместный, объединенный
hero|герой
clothes|одежда
easier|Более легкий
thorny|колючий, тернистый n
hers|ее
defiant|вызывающий, дерзкий
here|здесь, вот
finger|палец
chevy|охота, погоня, гнаться
groan|стон, стонать
trunk|ствол, туловище
imitate|подражать
theatre|театр
herd|стадо
vain|напрасный, тщетный
violent|яростный
mere|простой
lodging|квартира, жилье
polish|лак
decay|гниение, разложение
greeted|приветствовал
coral|Коралл
chess|шахматы
chest|грудь
vale|прощание
disease|болезнь
grip|схватывание
blossom|цветок , расцветать
grin|ухмыляться, усмешка
while|пока, в то время как, тогда как
grim|жестокий, свирепый, мрачный
sight|зрелище, вид, заметить, разглядеть
alibi|Алиби
errand|поручение
toil|трудиться,  труд
drum|барабан
stephen|Стивен
develop|развивать
gifted|одаренный
tease|дразнить, задира
drug|лекарство, наркотик
rip|рвать
puzzle|приводить в затруднение, загадка
cyclist|велосипедист
adapted|Приспособленный
broom|метла, мести
alias|Псевдоним
brook|ручей
rumour|слух, молва
dive|нырять
rig|снаряжение, экипаж
slacken|ослаблять, ослабевать
dodge|уловка, хитрость
brood|высиживать , выводок
offer|предлагать
suffix|суффикс
tears|слёзы
rim|ободок
angela|Анжела
rib|ребро
rid|освобождать
fought|сражался
amber|янтарь, янтарный
naked|обнаженный, голый
advance|продвижение вперед, продвигать
sugar|сахар
enslave|порабощать
appear|появляться
donkey|осел
flow|течение, поток, разливаться, течь
its|его, ее
cave|пещера
lick|лизать
exactly|точно, именно
fury|неистовство
weighty|веский
shelter|приют, убежище
fluid|жидкий, жидкость
furs|меха
potter|Гончар
drink|напиток, пить
appeal|апелляция, апеллировать , обращаться
pier|пристань, мол, свая, бык
throat|горло
signs|знаки, вывески
cheat|обманывать, надувать, обманщик, плут
sour|раздражительный, сердитый, кислый
nowhere|нигде, никуда
futile|бесполезный, тщетный, пустой
horrid|ужасный
laugh|смех, смеяться
iso|Международная организация по стандартизации
fuse|плавить, перегорать
under|под
soul|душа, воплощение
fuss|суета; суетиться, беспокоиться, хлопотать
goodbye|прощание
prey|жертва
suggest|предлагать, советовать
soup|суп
teams|команды
loaded|загруженный
system|система
thirty|тридцать
yonder|вон тот
favor|Польза
boxing|бокс
cheap|дешевый
rye|рожь
patrol|патруль
press|гладить, сжимать, нажимать, печать, пресса
sort|сорт, род, вид, сортировать
rug|ковер
charley|Чарли
lively|живой, оживленный
minimum|минимум
dimly|смутно
advise|советовать
charles|Чарльз
ivy|плющ
run|бегать, двигаться, бег, движение, направление
rum|ром, странный
odds|разница, неравенство
laundry|прачечная, стирка
iron|железо, утюг
perry|Перри
sore|больной, воспаленный
life|жизнь
truth|правда, истина
worked|работал, сработанный
rut|колея, привычка
moscow|Москва
worker|рабочий
pick|собирать, подбирать, выбирать
helium|Гелий
canteen|столовая
pinch|щипать, прищемить, щипок
bridle|узда, повод, взнуздывать
builds|Строит
trust|доверять, доверие, вера
rates|стоит
thirst|жажда
medium|средство, середина
gland|железа
remain|оставаться
insult|оскорбление
world|мир, свет
baggage|багаж
lateral|Боковой
wounded|раненый
cartoon|мультфильм
become|становиться
thicket|Чаща
shoved|Пихал
bowed|Поклонился
must|должен, надо
soot|сажа
removal|перемещение
cheeky|развязный
curious|любознательный
friends|друзья
care|заботиться, переживать
card|карточка
moist|сырой, влажный
deplore|сожалеть
demand|требовать
mute|немой
vase|ваза
agreed|согласился
spare|уделять, лишний, запасный
saved|спасал
indexes|Индексы
cart|телега, повозка
spark|искра
vary|отличаться, расходиться
upgrade|Модернизировать
tourist|турист
railway|железная дорога
cast|бросать, ронять, менять
mingled|Смешанный
soothe|успокаивать, утешать, облегчать
shovel|лопата
rub|тереть, стирать, трение
cash|деньги
shabby|потрепанный, поношенный
case|случай, состояние
teacher|учитель
thumb|большой палец
medal|медаль
oldest|старший, самый старый
early|рано
ailing|больной
softly|мягко, нежно
attempt|пробовать, пытаться, попытка
song|песня
walking|гуляющий
repulse|отражать , отвергать, отталкивать, отпор
impure|нечистый, грязный, с примесью
garment|одежда, одеяние
liar|лгун
regions|Области
acute|острый, проницательный
spared|Сэкономленный
cats|Коты
breach|брешь, пробивать брешь
pursue|преследование
lustre|блеск, лоск, глянец, люстра
vast|обширный, громадный
pigs|Свиньи
drill|дрель, тренировать
mercy|милость
beneath|под, ниже, внизу
chip|обломок, осколок
chin|подбородок
counter|прилавок, противостоять, противиться
walnut|грецкий орех
reign|царить, господствовать
helped|помогал
bending|Изгиб
torrent|поток
soon|скоро, рано
alarm|тревога,
seven|семь
charge|плата, стоимость, взимать плату
disdain|презирать, пренебрегать; презрение, пренебрежение
sons|сыновья
giant|гигант, гигантский
gloomy|мрачный
birth|рождение
caleb|Калеб
sterile|бесплодный
bates|Убавляет
sad|печальный
amazed|изумлённый, поражённый
cane|трость, палка
feels|Чувства
zero|ноль
feather|предмет гордости, достижение
sam|Сэм
ridge|горный хребет, гребень
jest|шутка; шутить, высмеивать
draw|рисовать
pins|значки
camp|лагерь
stock|запас, снабжать
sadly|печально
reform|улучшать, реформа
guards|Охраны
drive|водить машину, ехать на машине
carbon|углерод
slept|спал
pink|розовый
working|делающий, творящий
pine|сосна
sole|подошва, подметка; ставить подметку
sold|продавал, проданный
topic|тема
charms|Обаяния
elapse|проходить
matters|дела, материалы
like|любить, нравиться, похожий, подобный
topple|валиться
sap|сок ; подрывать
relieve|облегчать
visual|зрительный, наглядный
sat|сидел
cabbage|капуста
grown|выращенный
growl|рычать, ворчать; рычание, ворчание
say|сказать, говорить
closure|закрытие
bearing|Отношение
saw|видел, смотрел
toss|толчок, сотрясение, кидать, бросать
some|немного, несколько
dance|танцевать
outside|снаружи, наружный
stream|ручей, поток
scarlet|алый
avenge|мстить
cape|мыс
inhabit|жить, обитать
link|соединять, соединить
line|линия, специальность
growled|Рычал
bathe|купаться
words|слова
revert|возвращаться
pile|куча, груда, кипа, пачка
opposed|Противопоставленный
limp|хромота, прихрамывать
jerk|резкий толчок, подергивание; резко толкать, дергать
kitten|котенок
resolve|решать
corner|угол
drag|тащить
hoist|поднимать
prop|подпорка, опора, подпирать
crying|кричащий
lime|известь
injure|ушибиться -e
dandy|нарядный, великолепный
limb|конечность
remind|напоминать, напомнить
jumper|джемпер
arrange|устраивать, договариваться
broken|разбитый, сломанный, нарушенный, ломаный
lily|лилия
antony|Энтони
mamma|Мама
snoop|подсматривать
jumped|прыгал
pike|щука
injury|телесное повреждение
beacon|сигнальный огонь, маяк
brother|брат
tour|путешествие, тур
horror|ужас
snore|храпеть, храп
purse|кошелек
elton|Эльтон
remark|замечать, замечание
trumpet|труба
tidying|уборка
heat|жара
stalls|кресла в партере
anchor|якорь
bellamy|Беллами
bicycle|велосипед
habits|Привычки
heap|куча
hear|слышать
differs|Отличается
toward|к, на
police|полиция
heal|излечивать
budge|шевелиться
fund|фонд
head|голова, главный, руководить
drew|рисовал
sure|уверенный, убедиться, безусловно
cake|торт
cheer|настроение
nasty|скверный, плохой
frolic|веселиться, проказничать
exclaim|восклицать
jeanne|Джин
wants|хочет, желает, нуждается в
cheek|щека
soften|смягчать
dwarf|карлик, гном
hearing|слух
batch|выпечка, партия, группа
lift|поднимать, подъемник, лифт
policy|политика
town|город
diagram|диаграмма, схема
beech|бук
golden|золотой, золотистый
soil|почва
gurgle|бульканье
calm|успокаивать
call|звонить, называть
gross|большой
paper|бумага, газета
calf|слоненок, теленок, молодой кит
ruling|правящий
parked|Припаркованный
remiss|небрежный, вялый
pipe|труба
hanging|подвешивание
sofa|диван
another|еще один, другой
rider|наездник, всадник
raymond|Раймонд
full|полный
noisy|шумный
crackle|хрустеть, потрескивать
finding|находка, открытие, решение
glass|стакан, бокал
august|август
making|создание, становление
resumed|Возобновленный
chimney|труба
sixteen|шестнадцать
check|проверять, регистрировать
century|столетие, век
glare|сверкать
jeans|джинсы
came|пришел
teach|обучать, преподавать
soft|мягкий, тихий
noise|шум
riches|богатство, изобилие
deprive|лишать, отбирать
toys|игрушки
target|задание
facing|сидящий лицом
furious|взбешенный, бешеный, неистовый
pillar|колонна, столб
group|группа
average|средний
formula|формула
blessed|благословлённый
harass|беспокоить
abode|местопребывание, жилище
freedom|свобода
dudley|Дадли
visit|визит, посещать, навещать
lessen|уменьшать
wait|ждать, ожидать, ожидание
kid|ребенок
wail|вопль, вой, вопить, выть
located|Расположенный
turnip|репа
she|она
began|начинал, начал
partner|участник
black|черный
kit|ранец, багаж
asked|просил, требовал
limits|Пределы
moving|трогательный
death|смерть
awoke|будил
cleaned|чистил,
elliot|Эллиот
madame|Мадам
further|дальнейший, дополнительный
towns|Города
beaker|кубок, чаша
impress|производить впечатление
view|взгляд, мнение, осматривать
soap|мыло
explain|объяснять
owners|Владельцы
tunnel|тоннель
deserve|заслуживать
decent|приличный, скромный
pillow|подушка
acacia|акация
wizard|колдун, специалист своего дела
ocean|океан
acclaim|провозглашать
adhere|прилипать, приставать  , приклеиваться, хвататься
percy|Перси
six|шесть
naive|наивный
debris|обломки, развалины
wage|заработная плата
midday|полдень
smoking|курение
acted|Действовал
plains|Равнины
france|Франция
joining|соединение
italy|Италия
skirt|юбка
sunk|Погруженным
racket|ракетка
integer|Целое число
thou|Вы
glimpse|мелькание, мельком взглянуть
shy|застенчивый, робкий
blocks|кварталы
boat|лодка, пароход
sock|носок
sit|сидеть, заседать, годиться
amazing|Удивительный
history|история
sir|сэр
forever|вечно
hookup|Соединение
deeper|Глубже
conform|соответствовать, подчиняться
sunset|закат
sin|грех, грешить
smashed|Разбитый
nothing|ничто, ничего
hannah|Ханна
scenery|декорации
elderly|пожилой
bound|непременный, обязательный
warrant|полномочие, ордер, гарантировать
edition|издание
body|тело
babble|бормотание, болтовня
muggy|теплый, влажный, удушливый
stupid|глупый
enough|достаточный
aged|старый, в возрасте
mishap|неудача
brisk|живой, проворный
paying|платеж
light|свет, освещение, фара, освещать, зажигать
key|ключ
oneself|себя
bedside|постель
german|Немец
wagon|повозка
eager|нетерпеливый
subdued|подавленный
script|сценарий
agent|деятель, исполнитель
fleet|флот
saddle|седло, седлать
tooth|зуб
better|лучше
deity|божество
against|против
cove|сооружать
sprout|пускать ростки; отросток, побег
noises|Шумы
bible|библия
walk|гулять, ходить пешком
wall|стена
coarse|грубый
sew|шить
sex|пол
saying|говорящий
barge|баржа
merry|веселый, радостный
vice|порок
ruby|рубиновый
monarch|монарх
set|класть, ставить, помещать, комплект
shrill|резкий, пронзительный
plural|множественное число
flying|летающий, летный
wake|будить, просыпаться
stems|Стебли
artist|художник
society|общество
shrimp|креветка
edit|редактировать
funny|смешной, забавный
sea|море, океан
landed|земельный
czar|Царь
throng|толпиться, переполнять
throne|трон
anew|снова, заново
see|видеть, встретиться
wedding|свадьба, венчание
suit|костюм, подходить, устраивать
laying|Наложение
beasts|звери
outlaw|человек вне закона, изгнанник
salts|Соли
fringe|бахрома, край
manages|ухитряется
william|Уильям
they|они
scorn|презрение, презирать
parking|стоянка
concert|концерт
fell|упал
recipe|рецепт
manager|управляющий
yield|приносить
spy|шпион, шпионить
nine|девять
concern|забота
collar|воротник
glide|скользить, планировать
halted|Приостановленный
score|счет, отметка, выигрывать
peril|опасность
mariner|моряк
actor|актер
council|совет, совещание
chew|жевать
skinner|погонщик
dough|тесто
deliver|доставлять, передавать
weekend|выходные
combine|объединять
buyer|покупатель
embrace|обнимать, включать
cradle|колыбель, убаюкивать
worth|стоящий, заслуживающий
frosty|морозный
pigeon|голубь
shades|оттенки
lesson|урок
twelfth|двенадцатый
sow|сеять
church|церковь
windy|ветреный
vine|виноградная лоза
son|сын
stripes|Полосы
emotion|возбуждение
earlier|Ранее
skill|мастерство
russian|русский
them|их
then|тогда, потом, затем
erring|грешный, заблудший
records|пластинки
winds|Ветры
thee|Вас
sob|рыдание
raised|рельефный
subject|предмет, содержание, подчинять
merge|Слиться
plenty|изобилие, избыток, вполне, довольно
mantle|покрывать, окутывать
hammer|молоток
looking|смотрящий
oysters|устрицы
striped|полосатый
counsel|обсуждение, совет, решение, адвокат
ashore|на берег
usual|обыкновенный, обычный
polar|полярный
jacket|куртка
birch|береза, розга
scout|разведчик
hotter|жарче
intake|поглощение
larger|Больший
stern|строгий
darted|Брошенный
beings|Существа
hunter|охотник
kindly|добрый, добродушный, ласково, любезно
tobacco|табак
within|внутри, внутрь
design|проектировать, спроектировать
eerie|Жуткий
cause|дело, причина
second|второй, помощник, секунда
char|Случайная работа
permit|разрешать
chap|парень , малый
deeply|глубоко
firmly|твердо, решительно
study|учиться, изучать, заниматься, исследование, кабинет
chat|беседа, болтовня
middle|средний
deserts|заслуги
beloved|любимый
wager|держать пари, рисковать
pitiful|жалкий, ничтожный
looks|выглядит
sky|небо
level|уровень
wings|крылья
gather|собираться
sets|декорации
arctic|полярный, арктический
lever|рычаг
trials|Испытания
faults|Ошибки
ski|ходить на лыжах
such|такой
escort|охрана
doubt|сомнение, сомневаться
suck|сосать
minims|Мельчайшая частица, очень маленькая доля, капля
league|союз, лига
wade|пробираться, продираться
terrace|терраса
stuff|вещество, материал, заполнять, набивать
blouse|блуза
mother|мама
bough|ветвь, сук
gulped|Проглоченный
thin|тонкий, худощавый
bridge|мост
this|этот, это
release|освобождение, освобождать
mining|горный
concept|концепция, понятие, идея
bamboo|бамбук
scope|пределы
becomes|становится
cheese|сыр
affect|влиять, трогать, вредить
awful|ужасный
bellow|мычание, греметь, громыхать
swept|подметал
steve|Стив
real|реальный, настоящий
baron|Барон
poverty|бедность
induced|Вынужденный
read|читать
applet|Апплет
various|различный, разный
treated|лечил
stuck|воткнул, приклеил
seats|места
cheers|да здравствует
apples|яблоки
colored|Цветной
worst|наихудший
coach|тренировать, инструктор
shriek|кричать, вскрикнуть, пронзительный крик
rear|задняя часть
esteem|уважать, почитать, уважение
offence|обида
taught|обучал, обученный
harriet|Гарриет
jackal|шакал
stuffy|душный
worse|хуже
merit|достоинство
away|прочь
sly|хитрый
bleach|белить
felt|чувствовал
clasped|Сжатый
sprang|Прыгал
loosen|развязывать, распускать, ослаблять
fossil|ископаемое
curdle|свертываться
eating|прием пищи, еда
wrong|неправильный, не тот
runner|бегун
worry|беспокоиться
occupy|занимать, завоёвывать
grunt|хрюкать, хрюканье
skins|Кожи
guide|гид, экскурсовод
cleanup|Уборка
passed|прошел
braces|подтяжки
fight|бороться, бой
redeem|выкупать, искупать, выполнять
rung|ступенька, спица колеса
wrote|писал, написанный
saviour|спаситель
intrude|вторгаться, вмешиваться, навязываться
vanish|исчезать, пропадать
occurs|Происходит
showed|показал
bustle|суетиться, суматоха, суета
danced|танцевал
hooter|Гудок
scheme|проект
reduced|Уменьшенный
heroism|героизм, доблесть
snow|снег, падать
stamps|марки
points|Пункты
dictum|изречение, поговорка
conceit|самомнение
happen|случаться, происходить
murmur|шорох, шепот
clank|бряцать, хлопать в ладоши
brain|мозг
piece|кусок
turn|поворачивать, вращать, оборот, поворот, очередь
monster|чудовище
turk|Турок
builder|строитель
turf|дерн
dropped|потерянный, пролитый
afraid|испуганный
crime|преступление, преступность
shower|душ, ливень
twelve|двенадцать
fellow|человек, парень, приятель
guarded|Охраняемый
born|рожденный
rhyme|рифма, рифмовать
common|общий
woollen|шерстяной
bore|скука
undress|раздеваться
worlds|Миры
floored|поставил в тупик, сразил
wavy|волнистый, бурный
laden|Груженый, нагруженный, обремененный
figure|фигура
habit|привычка
josie|Джоси
civil|гражданский
grater|терка
seeds|Семена
crisis|кризис, перелом
bricks|кубики
rounded|Округленный
bliss|блаженство, счастье
surplus|излишек
comely|хорошенький, миловидный
mostly|главным образом
direct|прямой, руководить
stammer|заикаться, запинаться
reed|тростник, камыш
dolls|Куклы
absence|отсутствие
erect|строить
later|позже
parrot|попугай
boss|начальник
poured|Лил
reel|катушка, барабан
fault|вина, недостаток, ошибка
swindle|обман, обманывать, надувать
seller|торговец
dashed|брошенный
lucky|счастливый, удачный
clamp|складывать, скреплять
mixture|микстура
runs|Пробега
oblige|обязывать
feat|подвиг, ловкость, искусство
freeman|полноправный гражданин
scold|бранить, ругать
fear|страх, опасение, бояться, опасаться
salad|салат, винегрет
relate|относиться, связывать
detain|задерживать, удерживать
detail|деталь
envious|завистливый
both|оба
knitted|вязанный, трикотажный
terms|личные отношения, условия соглашения
album|альбом
wailed|Вопил
loose|свободный
abrupt|резкий, внезапный, крутой, обрывистый
confer|обсуждать, совещаться; вести переговоры с
after|после
commit|совершать
cherish|лелеять
soviet|Советский
eldest|старший
jug|кувшин
tennis|теннис
fruit|фрукты
stump|пень
latch|запирать
unable|неспособный
white|белый
horizon|горизонт
bout|черед, круг
willing|готовый, охотно делающий что-либо
worthy|достойный
that|это, тот, та, то
pearl|жемчуг, жемчужный
than|чем
recite|рассказывать, перечислять
thence|Отсюда
races|Гонки
pears|груши
thaw|оттепель
sue|преследовать судебным порядком, возбуждать дело в суде
cries|Крики
model|модель
humble|скромный
brick|кирпич
about|о
sum|сумма, подводить итог
draught|сквозняк, набросок, черновик
sun|солнце
ruth|жалость, сочувствие, участие, сострадание
elder|старший
disgust|отвращение, вызывать отвращение
norris|Норрис
grumble|ворчать
vanity|тщеславие
brace|связывать, скреплять
clutch|захват
above|над, выше, наверху
fearful|страшный
feed|кормить
severe|суровый, жестокий
accent|подчеркивать, произносить
rust|ржавчина, ржаветь
bride|невеста
honour|честь
ominous|зловещий
bowl|кубок, чаша
feel|чувствовать
rush|устремляться, бросаться, мчаться
cease|прекращать, останавливать
promise|обещать
feet|ноги, ступни
punish|наказывать, наказать
descent|спуск, склон, десант, происхождение
climax|кульминационный пункт
variety|разнообразие
sauce|соус, приправа, поливать соусом
ruse|уловка, хитрость
plainly|Явно
organic|органический
blink|мерцание, отблеск, блеснуть, моргать
flaming|Пылающий
beaten|битый
whoever|кто бы ни
outdoor|на открытом воздухе
grow|расти
service|сервис, обслуживание
circuit|кругооборот, окружность
relish|вкус, привкус, смаковать
descend|спускаться
claim|требовать
tight|плотный, крепкий, тугой
blind|слепой
brief|короткий, сводка, резюме
gleamed|Мерцал
sword|меч, шпага, сабля
malice|злоба
selfish|эгоистичный
tag|бирка, ярлык
accept|принимать
toddle|ковыляние, прогуливаться
cuckoo|кукушка
tab|петелька
dial|набирать номер
bring|приносить, приводить
corrupt|испорченный, развращенный, продажный
sailor|матрос
conceal|скрывать, утаивать
hopper|Бункер
whisper|шепот, шептать
ancient|древний
farmer|фермер
weather|погода
false|ложный
hopped|Прыгал
choose|выбирать
rubbing|Протирка
rooms|комнаты
wine|вино, винный, пить вино
wind|ветер, виток, виться, наматывать
rude|грубый, резкий, невоспитанный
wing|крыло
ported|Перенесенный, транспортированный
wishes|пожелания
wink|моргать, мигать, моргание, мигание
prevent|предотвращать, препятствовать
porter|носильщик
banged|ударенный
boil|кипятить, кипеть
traced|Прослеженный
soldier|солдат
shrine|сохранять
ward|опека
tax|налог
coins|монеты
flesh|тело, плоть, мясо
shrink|отпрянуть, садиться
tar|смола, деготь; мазать дегтем, смолить
nails|ногти
tap|постучать
doorway|дверной проем
episode|эпизод
tiger|тигр
comedy|комедия
knights|Рыцари
traces|Следы
failed|потерпел неудачу, не удалось
boiled|вареный, кипяченый
sphere|сфера
rarely|редко
wand|Палочка
title|заглавие, титул
tinker|Ремесленник
latter|последний
mirth|веселье, радость
length|длина
rent|брать напрокат, снимать жилье, квартирная плата
knees|колени
boiler|котел
want|хотеть, желать, нуждаться в
steak|бифштекс
hence|следовательно
steal|воровать
concede|уступать, допускать
smartly|ловко
rely|полагаться, доверять
edge|край, точить
crisp|хрустящий картофель
heaven|небо, небеса, бог, провидение
warily|осторожно
luckily|к счастью
wipe|вытирать
ankle|щиколотка, лодыжка
access|доступ, подход, доступность
wholly|полностью
stun|оглушать
barrow|носилки
stud|запонка
brand|головня, клеймо, фабричная марка, сорт, клеймить
summit|вершина
based|Основанный
steam|пар
goose|гусь
users|Пользователи
bolt|молния
hated|ненавидел
diet|диета
wish|желание, желать
wise|мудрый
ruin|гибель
renew|обновлять
anyway|во что бы то ни стало
tools|инструменты
bennet|Беннет
bold|смелый
died|умер, умерший
halfway|на полпути
philip|Филип
dwight|Дуайт
custom|обычай
accuse|обвинять
murder|убийство
succeed|достигать цели
eagle|орел
hooker|Проститутка
clasp|прижимать
wire|переводить телеграфом
turner|токарь
tinkle|звон, звяканье
class|класс
sense|чувство, здравый смысл, чувствовать
staying|остающийся, живущий
bully|запугивать
winning|выигрывающий, победа
pierce|пронзать, протыкать, пронизывать, проникать
blades|Лезвия
window|окно, оконный
popular|популярный
bomb|бомба, бомбить
wave|волна
beating|поражение
summon|вызывать
hatch|высиживать
rest|остальное, остальные, остаток
clash|столкновение, конфликт
bidding|понижение цены
friend|друг
warn|предупреждать
stop|остановка, перестать, остановиться
warm|теплый, согревать
voice|голос
leaped|Прыгал
harbour|гавань
wars|Войны
stocks|Акции
reared|Воздвигнутый
pretty|хороший, значительный
merely|единственно
coast|побережье
doubts|Сомнения
during|во время
cunning|хитрость, хитрый, коварный
wary|осторожный
sunny|солнечный
triple|тройной
rule|правило, принцип, норма, управлять, решать
bone|кость
bulky|громоздкий
meat|мясо, мясной
wash|мыть, стирать, мытье, стирка
dick|Дик
rhythm|ритм
mean|означать
baker|пекарь, булочник
brake|тормоз
meal|еда, есть, принимать пищу
office|офис, контора
marine|морской флот, морской
with|с
boot|ботинок, сапог
mistake|ошибка
wasp|оса
desire|желание
flowing|течение
matter|дело, сущность, материал
steep|крутой
gesture|жест
steel|сталь
rules|правила
coats|Пальто
ruler|линейка, правитель
stocky|коренастый, низкий, приземистый
manual|ручной
wits|Остроумие
rubbish|ерунда, мусор
observe|наблюдать, замечать
steer|править
entry|вход
book|книга, покупать
anna|Анна
humbug|обманщик, ханжа
anne|Энн
sally|поездка, прогулка
literal|буквальный
blazing|Сверкание
bright|ясный
praised|хвалил
tend|иметь тенденцию
bacon|бекон
parts|части
smoked|курил
party|вечеринка, группа
spoke|говорил, говоривший
colour|цвет
mallet|деревянный молоток
ironic|иронический
created|Созданный
flutter|махать
tent|палатка
salary|оклад
objects|Объекты
hungry|голодный
these|эти, это
else|еще, кроме
billy|Билли
patted|Ласкал
conquer|завоевывать, завоевать
pencil|карандаш
project|проект
bit|кусочек, немного
aspect|взгляд, точка зрения
urge|понуждать
frames|оправы, рамки
nephew|племянник
discuss|обсуждать
opening|начало, открытие
smoker|курящий, вагон для курящих
bitter|горький, мучительный
sick|больной
pills|таблетки
each|каждый
bin|бункер
big|большой
shorter|короче
senses|Чувства
muzzle|морда, намордник, дуло
nail|ноготь, гвоздь
unique|Уникальный
drove|водил машину, ехал на машине
rival|соперник, соперничающий
refrain|удерживать, сдерживать, воздерживаться
grind|молоть, толочь, точить
bathing|купание, купальный
toilet|туалет
side|сторона, бок, край
ninety|девяносто
tell|говорить, рассказывать
crawled|Ползал
chamber|палата
define|определять, устанавливать
stir|суета, суматоха, мешать, помешивать, волновать
slaves|рабы
razor|бритва
ordinal|порядковый
digging|Рытье
morning|утро
upwards|вверх
manners|способы
drown|тонуть, топить, заглушать
invest|вкладывать, помещать
sneer|усмешка, насмешка; насмехаться, издеваться
unkind|недобрый
testing|испытание
precise|точный
ham|ветчина
visible|видимый, очевидный
postman|почтальон
rusty|заржавленный, порыжевший
lucius|Лусиус
bog|трясина
cruise|морское путешествие
has|имеет
backs|Задние части
hat|шляпа
maxim|принцип
planet|планета
aboard|на корабле, на борту, в вагоне
tally|бирка, этикетка, дубликат, копия
snuff|Нюхнуть
wanting|Желание
kerb|обочина
foliage|листва
friday|пятница
planes|самолеты
climate|климат
had|вспомогательный глагол, имел , не has
crack|попытка, проба, трещина
potions|Микстуры
scared|напуганный
seventh|седьмой
rivers|Реки
utter|издавать , произносить
sign|подписывать, знак, вывеска
refuse|отказывать
discern|различать, видеть
offend|обижать, обидеть
serving|порция s
hay|сено
crude|сырой, необработанный
sigh|вздыхать, вздох
seventy|семьдесят
measure|мера
lizzie|Автомобильчик
granted|дарованный
pulse|пульс, пульсировать
twins|близнецы
pat|хлопок
chapter|глава
invent|изобретать, изобрести
pilot|пилот
paw|лапа
name|имя, фамилия, называть
spoil|портить, баловать
pay|платить, зарплата
tonight|сегодня вечером
locate|определять местоположение
onion|лук
quarrel|ссора, ссориться
music|музыка
pad|мягкая прокладка, подушка; подбивать
depend|зависеть
viewed|Рассматриваемый
pal|приятель, товарищ, дружок
tracks|Следы
forge|выдумывать
mutiny|мятеж, поднять мятеж
scarce|редкий, едва
pan|сковорода
neither|также не
never|никогда
motives|Поводы
there|там, туда, вот
box|ящик, коробка, ложа
bow|кланяться, сгибаться
balmy|душистый, нежный, целебный
boy|мальчик, юноша
eternal|вечный
govern|управлять
knowing|знание, знающий
tomato|томат, помидор
lobby|вестибюль
louisa|Луиза
manure|удобрение
somehow|как-нибудь, так или иначе
verify|проверять, подтверждать
package|пакет
louise|Луиза
involve|втягивать, вовлекать
vigour|сила, энергия
shortly|вскоре
hey|эй
zoo|зоопарк
crumble|крошить
among|среди
blend|смешивать, смесь
assault|нападать, нападение
her|ее, ей
blown|Сдутый
smile|улыбаться, улыбка
hen|курица
itself|себя, себе
hem|рубец, кромка, кайма; подшивать, подрубать
spots|Пятна
ban|запрещать
final|окончательный
bag|сумка
mexican|Мексиканец
career|профессия, карьера
canyon|Каньон
hopes|Надежды
pointed|острый, многозначительный, совершенно очевидный
bad|плохой
bab|Бэб
prone|склонный
warrior|воин
bay|бухта, залив
colony|колония
hoped|надеялся
perfume|духи
bat|бить
bar|бар
foam|пена
foal|жеребенок
dalton|Далтон
spout|носик , желоб
proof|доказательство
kings|Короли
cruel|жестокий, беспощадный
gained|Полученный
gossip|сплетня
shindy|шум, скандал
unless|если не, пока не
listen|слушать
greatly|очень
kept|заставил
stay|оставаться, жить
pea|горох
gallery|галерея
star|звезда
exceed|превышать, превосходить
void|лишенный, недействительный
sedate|спокойный
denied|Отклоненный
brings|Приносит
exclude|исключать
tales|сказки, истории
pen|ручка
per|в
begun|Начатый
pet|любимое домашнее животное, любимец
twist|вить, крутить, скручивать
peg|целиться
paws|Лапы
fishing|рыбная ловля
force|сила
chemist|химик, аптекарь
closely|близко, тесно
grill|решетка
finds|Находит
wisdom|мудрость
hip|ягода шиповника
spoon|ложка
since|с тех пор как
him|его, ему
type|тип, род
helmet|шлем, каска
padlock|висячий замок
changed|поменял, изменил
cooler|холоднее
angles|Углы
ashes|Пепел
his|его
hit|успех, удача, попадать в цель
tear|слеза, разрыв, рвать
primary|первичный
buzz|жужжать, гудеть, жужжание, гул
exact|точный
flowery|цветистый
piteous|жалкий, жалобный
onto|на
cycle|цикл, период
approve|одобрять
detach|отделять, посылать
beg|просить, умолять
bee|пчела
bed|постель
fatal|фатальный
locking|Захват
means|средство, способ
meant|означаемый, подразумеваемый
enter|входить, поступать
team|команда
ben|Бен
dinner|обед
paul|пол
fined|штрафовал, оштрафованный
whole|целый, весь, целое
bless|благословлять
crumb|крошка
bet|держать пари, пари
owner|владелец
hybrid|Гибрид
surely|несомненно
grease|жир, сало, мазь, смазка; смазывать
quick|быстрый
goods|товары
ease|покой, непринужденность
indoors|в помещении
tyre|шина
digest|переваривать, усваивать, краткое изложение
bruises|Ушибы
tribute|дань
roller|ролик
santos|Сантус
arrest|арестовывать, арест
path|тропинка, беговая дорожка
east|восток, восточный
bid|Предложение
revenue|доход
denial|отрицание, опровержение
stew|тушеное мясо
despair|отчаяние
annual|годовой, ежегодный, ежегодник
your|ваш, твой
play|играть, игра
inject|впрыскивать
sport|спорт, заниматься спортом
modify|модифицировать
bloom|цветение
creeper|вьющееся растение
past|после, за
pie|пирог
troops|войска
pig|свинья
pass|передавать, проходить, пропуск, перевал
greasy|жирный, сальный
earl|граф
meals|еда
plan|план, планировать
pin|булавка, значок, прикалывать
night|ночь
stem|стержень
proud|гордый
pit|яма, партер
navy|военный флот
earn|зарабатывать
step|шаг, шагать
energy|энергия, сила
changes|меняется
buoy|буй, бакен
blond|белокурый
nice|хороший, чудесный, приятный
snapped|Сфотографированный
pop|поп, популярный
admiral|адмирал
deluge|наводнение, ливень
pot|котелок
matches|Сделки, спички
meter|счетчик
tenant|арендатор, жилец
tumbled|Кувыркался
awfully|ужасно, очень , крайне
pod|стручок, лущить
prove|доказывать, доказать
curled|Вился
vote|голос , голосование, голосовать
heads|головы
sledge|ехать на санях
absurd|нелепый
sire|Родитель
doze|дремать
quiet|тихий, спокойный
became|становился, стал
blood|кровь
badger|барсук, травить
temple|храм
obey|подчиняться, слушаться
colonel|полковник
nick|Зарубка
alfred|Альфред
dummy|манекен, макет
crane|журавль, подъемный кран
theft|кража
extinct|потухший , вымерший
complex|сложный, составной, комплексный
god|бог, божество
hobble|хромота, прихрамывать, ковылять
sought|Искавший
plants|Заводы
beth|Бет
bump|удар, толчок, шишка, ударять, стукаться m
useless|бесполезный
haunt|преследовать
farrier|Кузнец
best|наилучший
syringe|шприц
carton|коробка
gold|золото, золотой
reptile|пресмыкающееся
site|местоположение
weed|сорняк, полоть
valiant|храбрый, мужественный
dressed|одетый
thorn|шип, колючка
wedge|клин
divide|делить, отделять
bull|бык
kidnap|похищать
bulk|груз, величина
exhibit|экспонат, показывать
wrinkle|морщина, морщить
weep|плакать
gave|дал
grabbed|Захваченный
pleaded|Умолял
bulb|луковица, электрическая лампочка
unaware|незнающий
sorry|сожалеющий, печальный, унылый
lumber|лесоматериалы
october|октябрь
down|внизу, вниз
week|неделя
behaved|Вел себя
sulphur|сера
unload|разгружать
hills|Холмы
strap|ремень, стягивать ремнем
percent|процент
splash|брызгать; плеск, брызги
coolly|Прохладно
bust|бюст
straw|пустяк, мелочь
bend|гнуться, изгибаться
busy|занятый
absent|отсутствующий
good|хороший, добрый, добро, польза
stray|сбиваться с пути, заблудившийся
ballast|балласт, опыт, убеждения
grief|горе
mankind|человечество
whereby|чем, при помощи
audible|слышный, слышимый
metal|металл, металлический
bush|куст
sooner|охотнее
dots|Точки
leather|кожа, кожаный
crash|потерпеть крах, потерпеть крушение
control|контроль, управление
belief|вера, доверие
imagine|думать, воображать
whose|чей
cavern|Пещера
behind|позади
bury|хоронить, прятать
tumble|падать, опрокидываться
prolong|продлевать
pub|трактир, гостиница
dove|голубь
salute|приветствовать, салют
whereas|тогда как, принимая во внимание
bell|звонок
gride|Скрип
heroic|героический
unfit|негодный, неподходящий
belt|пояс, ремень
gos|Идет
burn|гореть, жечь, сжигать
got|получил, полученный
crust|корка, кора
car|машина
cat|кошка
can|уметь, мочь
cap|шапка
canoe|челн, байдарка
struck|забастовка, удар
dose|доза, дозировать
cab|наемный экипаж, извозчик, такси
arose|возник, появился
sounds|звучит
enclose|окружать
thong|ремень, плеть
argue|спорить
pry|любопытный человек
orchard|фруктовый сад
you|вы, ты
regret|жалеть
peaches|персики
tumbler|Тумблер
tables|Столы
couch|кушетка
pre|Пред
ordered|приказал
learned|ученый
gaze|пристально глядеть, пристальный взгляд
goon|придурок
freight|груз, грузовой
actual|текущий, современный
weak|слабый
sierra|горная цепь
latest|последний
wear|одежда, носить, быть одетым
clause|предложение, статья
bent|склонность, наклонность
curve|изгиб, гнуть
craft|искусство, судно
quill|катушка
people|люди
beyond|далеко, вдали, на расстоянии, вне, сверх
canes|Тростники
gosh|боже
insane|душевнобольной, ненормальный
sustain|поддерживать
bugs|Ошибки
rover|скиталец, странник
shadow|тень, покров, заслонять
gum|смола, клей; склеивать
bottles|бутылки
fifty|пятьдесят
mallow|Просвирник
abbey|Аббатство
mercury|ртуть
games|игры
unlock|отпирать
pairs|Пары
mainly|главным образом
piled|Сложенный
jealous|ревнивый
waving|Помахивание
hobby|хобби
plough|пахать
backed|Поддержанный
afore|перед
inspect|осматривать, инспектировать
legacy|наследство
lemon|лимон
put|класть, размещать
sieve|решето, сито
pun|каламбур
block|блок, квартал
switch|переключать, включать, выключатель, выключать
outline|контур, конспект, план, схема; краткое содержание
buds|почка, расцветать
aliases|Псевдонимы
pug|мопс, моська, курносый нос
serpent|змея, змей
twice|дважды, вдвое
jewel|драгоценность
eaten|eat
delete|Удалить
opera|опера
eater|едок
despise|презирать -e
jury|присяжные, жюри
just|только, всего лишь, справедливый
silk|шелковый, шелк
sill|подоконник
extreme|чрезвычайный, крайность
fifth|пятый
guy|парень
theme|тема
tedious|скучный, утомительный d
excited|взволнованный, возбуждённый
anguish|страдание
gus|Гас
kernel|ядро, зерно
notions|Понятия
gun|ружье, пушка
degree|степень, звание
bun|булочка
bum|бездельник, бродяга
bug|клоп, насекомое, жук
curse|проклятие
badge|знак, символ, эмблема
gang|шайка, банда
bud|почка, бутон, давать почки, пускать ростки
swift|быстрый
despite|несмотря на
but|но
outlet|выход, выходное отверстие
bus|автобус
mystery|тайна
persian|Персидский
buy|покупать, купить
herein|в этом, при сем
beef|говядина
amongst|Среди
raising|воспитание
travel|путешествовать
used|использованный, подержанный
been|быть
ledge|выступ, край
geology|геология
bees|Пчелы
beer|пиво
hurry|спешить, торопиться, спешка
survey|осмотр
longer|длиннее
totally|полностью
gown|платье
july|июль
swing|качание, качели, качаться, колебаться
admired|восхищался
hissed|шипящий
divine|божественный
tongue|язык
pains|боли, страдания
sink|тонуть
paint|красить, краска
strip|полоса
savoury|вкусный, пикантный, приятный
gate|ворота, проход
jump|прыгать
picture|картина, изображение, рисовать, описывать
bonfire|костер
booklet|брошюра, буклет
stories|истории, рассказы
beds|Кровати
smack|рыболовное судно
sing|пение, петь
rejoice|радовать
stretch|растягивать, вытягиваться
blobs|Капли
pitch|бросок, уровень, сооружать
diving|ныряние
russell|Русселл
trolley|тележка
erase|стирать
june|июнь
movies|кино, фильмы
calling|звонящий
north|север
ashamed|пристыженный
ernest|Эрнест
fulfil|выполнить
joking|шутка, шутящий
junk|рухлядь
upper|верхний
orderly|аккуратный
gasp|задыхаться
hopeful|надеющийся, подающий надежды, многообещающий
tones|Тоны
pickles|маринованные огурцы
lately|за последнее время
resort|обращение, обращаться
exist|существовать, жить
fatty|жирный
misty|туманный m
hurts|болеет, причиняет боль, повреждает
tongs|щипцы, клещи
cages|Клетки
bye|пока
unmoved|равнодушный
begin|начинать
tower|башня
organ|орган
quite|вполне, совсем
pearls|Жемчуг
towel|полотенце
rifle|ружье, винтовка
their|их
kidney|почка
user|потребитель
storage|хранение
river|река
clients|Клиенты
auction|аукцион
stork|аист
solemn|серьезный, торжественный
said|сказал
store|магазин, имущество, запасать, снабжать
stuffed|Наполненный
columns|Колонки
college|колледж
jeff|Джеф
sham|притворство, обман
apricot|абрикос
ghost|привидение, дух
storm|буря, взрыв
failing|Неудача
lord|лорд
sausage|колбаса, сосиска
story|рассказ, история
deed|подвиг, дело
solely|Исключительно
curls|Завитки
sorting|Сортировка
sail|парус, плыть
jeer|насмешка
deep|глубокий
instant|мгновение
deer|олень, лань
breath|дыхание
wiped|Вытертый
forgive|прощать
valleys|Долины
engine|двигатель, мотор, машина
wretch|несчастный, негодяй
plate|тарелка
harness|упряжь, запрягать
mood|настроение
image|изображение, образ, имидж
miles|мили
confess|признавать
betray|предавать
breast|грудь
magic|волшебный
voyage|путешествие
aim|целиться, цель
paste|тесто, клейстер, паста; клеить, склеивать
butter|масло
retain|удерживать
binding|переплет
air|воздушный, авиационный, проветривать
beck|кивок, приветствие
puddle|лужица, смущать, барахтаться в воде
keeping|хранение, содержание, согласие
hammock|гамак
immense|громадный, необъятный
zinc|цинк, цинковый, оцинковывать
gift|подарок
idea|идея, мысль
mole|крот
barely|только, едва
satisfy|удовлетворять
raise|поднимать, возвышать
marched|Прошел
shrub|куст
servant|слуга
deploy|развертывать
aid|помощь
shrug|пожимать плечами
burial|похороны
repent|раскаиваться
stops|остановки
fencing|ограждение
degrade|понижать, разжаловать
faster|быстрее
loot|ограбление
bagful|мешок
waspish|злой, раздражительный
battery|аккумулятор
domain|Область
current|течение, ток
loop|петля
sheep|овца, овцы
left|покинутый, оставленный
favour|одолжение, услуга, польза
jewels|драгоценности
sheer|настоящий
deck|палуба
loom|принимать размеры
sheet|простыня, лист, пласт
fasten|прикреплять
weekly|еженедельный, еженедельно
bear|медведь, спекулянт
install|водворять, устраивать, устанавливать
look|смотреть, выглядеть, взгляд, внешность
safe|сейф, безопасный, надежный
beat|ударить, бить
beau|кавалер, поклонник
bean|боб
debt|долг
wreck|крушение
cracker|печенье, хлопушка
stool|табуретка
stoop|наклонять, сутулиться, горбиться
aha|Ага
gain|прибыль
yes|да
barley|ячмень
cocoa|какао
beak|клюв
beam|сиять, излучать
angeles|Анхелес
napkin|салфетка, пеленка
yet|однако, еще
dwell|жить
gravely|серьезно, здраво, рассудительно
player|плейер, игрок
quiver|дрожать, трепетать; дрожь; трепет
normal|нормальный
driving|езда, вождение, движущий
stone|камень
tragedy|трагедия
plays|играет
chilly|холодный, сухой, чопорный
dear|дорогой
long|длинный, долгий, долго
wallet|бумажник
dock|док, пристань
informs|Сообщает
pompey|Помпей
deal|значительное количество
autumn|осень
expose|выставлять, подвергать, разоблачать
dean|декан
capture|захват, поймать
liberal|либеральный, щедрый; либерал
tommy|Томми
dead|мертвый
ant|муравей
dignity|достоинство
deaf|глухой
victory|победа
radiant|лучистый, сияющий, лучезарный
priest|священник
seeing|видящий
likely|вероятно
vault|свод
ana|сборник изречений
lent|одолжил, дал в долг
drain|вытекание
lens|линза
and|и, а
decided|решил
holiday|отпуск, праздник
amy|Эми
played|играл
maximum|Максимум
seeming|видимый, мнимый
thrive|преуспевать; буйно, пышно расти
roman|Католик
phase|фаза, фазировать
enforce|принуждать, навязывать, проводить в жизнь
lend|дать в долг
dazed|ошеломленный
collect|коллекционировать
galaxy|Галактика
does|делать, действовать, вспомогательный глагол
skiing|катание на лыжах
doer|исполнитель
boast|хвастовство, хвастать
icy|ледяной
rainy|дождливый
garage|гараж
gale|шторм
waist|талия
colon|двоеточие
chisel|резец, ваять, высекать
husband|муж
lighter|зажигалка
accused|Обвиняемый
sack|мешок
torches|фонарики
defence|оборона, защита
apex|верхушка, вершина
hands|руки
ice|лед
nicely|хорошо
disable|делать непригодным
buried|спрятанный, похороненный
handy|удобный; ловкий, искусный
all|все, весь
members|члены
sample|образец
trophy|трофей
export|экспорт, экспортировать
speed|скорость, ускорять, спешить
cram|запихивать, пичкать, учить наспех, натаскивать
boats|лодки
apes|Обезьяны
game|игра
walter|Уолтер
crab|краб
memory|память
urban|городской
shed|сарай
draft|чертеж, проект
reckon|считать
color|Цвет
decency|приличие, благопристойность
cruelty|жестокость
heating|отопление
badly|сильно, плохо
manner|способ, образ действия, манера
forget|забыть
growth|рост
newly|вновь
abc|алфавит, азбука, букварь, начатки, основы
supreme|верховный, высший
door|дверь
luggage|багаж
ardent|пылкий
bother|беспокойство, хлопоты; источник беспокойства
fixed|назначил
doom|обрекать
twisted|искривленный
slime|слизь, липкая грязь, ил; комбинация
rouse|будить, побуждать
dried|сушеный
correct|исправлять, правильный
realm|Царство
button|кнопка, пуговица
feast|пир
prosper|процветать
idiot|идиот
dene|долина, дюны
tramp|бродить, громко топать, бродяга
knob|knob
move|двигать, переезжать
legally|законно
reins|поводья, вожжи
maybe|мoжет быть
done|сделанный
cliff|утес, скала
colin|Колин
board|садиться на пароход, самолет; доска
pursuit|преследование, погоня, занятие
commend|хвалить
melon|дыня
month|месяц
delay|отсрочка
bodies|Органы
comment|комментарий, комментировать
small|маленький, тонкий, скромный
wisely|мудро
varied|Различный
region|район, область
plant|завод, растение, сажать, внедрять, посадить
expert|эксперт
plans|планы
strain|натягивать, напрягать, напряжение
crew|судовая команда, экипаж
moss|мох
plank|доска
click|щелкать
most|самый, весьма
strait|узкий, пролив, затруднительное материальное положение, нужда
utmost|крайний
aside|в сторону
roused|Разбуженный
thrill|волновать
tiptoe|кончики пальцев, цыпочки
inhale|вдыхать
sharpen|точить
porch|крыльцо,  веранда, терраса
moth|моль, мотылек
backup|Резервный
untidy|неаккуратный
vague|неопределенный, смутный
crawl|ползать
abide|ждать, терпеть
product|продукция
idle|бесполезный
plane|самолет
valve|клапан, створка, радио электронная лампа
route|маршрут, путь, направлять
alexis|Алексис
item|вещь, предмет
account|счет, оценка, причина
hoard|запас; запасать, копить
earth|земля
puff|дымок, дуновение ; дымить, попыхивать
scholar|ученый
produce|производить
jean|Хлопчатобумажная ткань
reveal|обнаруживать
skilled|квалифицированный, умелый, ловкий
cousin|двоюродный брат
cooked|готовил
bracket|скобка, подпорка, заключать в скобки
fatigue|усталость, утомлять
temper|сдержанность, самообладание
carved|вырезанный
love|любовь, любить
more|еще, больше
eminent|выдающийся
bikes|Велосипеды
trail|след
age|век, возраст
value|ценность, цена, дорожить, ценить
train|поезд, привлекать, воспитывать
noble|благородный, знатный
spell|писать или произносить  по буквам
lover|любитель, возлюбленный
stove|печь, плита
inn|гостиница, постоялый двор
stature|рост
scream|вскрикнуть, зареветь, визг, вопль
lots|уйма, куча, множество
glance|взглянуть, мелькнуть
tablets|таблетки
gipsy|цыганский, цыган
ink|чернила
studied|учился
sharply|резко
stout|тучный, дородный
pursued|Преследуемый
caesar|Каесар
loud|громкий
measles|корь
endure|Вынести
lightly|слегка
parents|родители
moon|луна
lost|потерял, проиграл, потерянный, проигранный
loss|потеря, утрата
outfit|снаряжение, обмундирование, оборудование
theory|теория
dome|купол
drift|сносить, плыть по течению
add|добавлять, прибавлять
playing|играющий
agony|мучение, сильная боль
crazy|безумный
ample|обширный, просторный
diamond|алмаз, бриллиант
spent|проводил, тратил, проведенный, потраченный
ads|реклама
less|менее, в меньшей степени
statute|закон, устав
those|тот, та, то, те
doll|кукла
dispose|располагать
ill|больной
expel|изгонять, исключать
agency|агентство
smash|бить, разбивать
quoted|Указанный
loved|любил
rapid|быстрый
devil|дьявол, сатана
know|знать
filling|заполнение, наполнение
knot|узел, завязывать узел
spend|тратить
apparel|одевать, наряжать
lose|терять, проигрывать
squeal|Визг -a
twenty|двадцать
fixes|Устанавливает
blue|синий
glands|Гланды
violet|фиолетовый
hostile|враждебный
tighten|сжимать
meadow|луг
removed|удалённый
defy|действовать наперекор
local|местный
act|акт, дело, действовать
smart|изящный
greater|больше
bench|скамейка
nulls|Пустые указатели
knew|знал
winner|победитель
ready|готовый
spot|пятно
veteran|ветеран
forgot|забыл
place|место
serious|серьезный
suicide|самоубийство, самоубийца
slack|ленивый, слабый, ослаблять, утихать
knee|колено
handbag|дамская сумочка
rubber|резина
how|как
journey|путешествие
cling|цепляться, льнуть
loan|заём, ссуда
clink|звенеть, звон
grace|грация, изящество
pure|чистый
hog|свинья, боров
loaf|безделье
sophia|София
toad|жаба
hot|горячий
load|нагрузка, нагружать
nearby|поблизости
hop|хмель
harp|арфа
presume|предполагать
climb|подниматься, влезать
thrice|трижды
harm|беда, неприятность
killed|убил
choice|выбор
give|давать
events|События
hari|Хари
hardly|едва
snorted|Фыркал
desk|письменный стол
brought|принес, принесенный
gravel|гравий
hart|олень
running|пробег, бегущий
hoe|мотыга, рыхлить землю
plot|заговор
tempted|Соблазненный
easy|легкий, простой
tucked|Подвернутый
racing|гоночный
bodily|лично, сам, собственной персоной
fierce|свирепый
denote|означать, обозначать
grade|сортировать, степень
hare|заяц
slide|скользить
hard|с трудом, тяжело
ability|способность
scratch|царапать
outward|внешний, наружный
trips|поездки
plump|пухлый, полный
park|парк,
induce|убеждать
plums|сливы
plume|перо
front|перед, передняя сторона, фронт
speaks|Говорит
incline|склонять
field|поле
peering|Глядя
banana|банан
orphan|сирота, сиротский
isle|остров
pistol|револьвер, пистолет
weapon|оружие
string|вереница, ряд, струна, связывать
keen|страстный
slice|ломоть
keel|киль
part|часть, доля, роль, делить, расставаться, расходиться
robber|грабитель
aye|Утвердительный ответ, положительный ответ
afford|позволить себе
keep|держать, сохранять
flinch|отступать, вздрагивать
hall|зал
hug|крепко обнимать
pull|тянуть, тащить
frost|мороз
crow|ворона
half|половина
round|круг, цикл, полный, круглый
pulp|мякоть, бумажная масса
cancel|отменить, сократить
poorly|плохо, неважно
crop|урожай
handled|Обработанный
lobes|Лепестки
amount|количество, сумма, составлять
knit|вязать, связывать
welcome|желанный, гостеприимство
signify|значить, означать, иметь значение
tickets|билеты
dessert|десерт
text|текст
verse|стихи, поэзия
submit|подчиняться
fowl|птица
shallow|мелкий, поверхностный, мель
eloise|Элоиза
pump|насос
pale|бледный
effort|усилие, напряжение
reduce|уменьшать, понижать, сокращать
nation|нация, народ
helpful|полезный
palm|ладонь
james|Джеймс
finish|кончать, конец, финиш
input|Вход
hybrids|Гибриды
scuba|Акваланг
laurie|Лаури
carlos|Карлос
spur|стимул
natural|естественный
adept|знаток, сторонник
hans|Ханьшуй
hockey|хоккей
archaic|устарелый, архаический
faintly|слабо
trade|торговать, ремесло, занятие, профессия
strings|Вереницы
signal|сигнал, сигнализировать
repeat|твердить, говорить наизусть
hang|повесить, висеть
appears|Появляется
consume|потреблять
hand|рука
journal|журнал
liberty|свобода
reach|достигать
hrs|Часы
shut|закрывать, запирать, замолчать
prince|принц
deny|отрицать, отвергать
bunch|связка, пучок
four|четыре
plain|ясный, очевидный, равнина
react|реагировать
foul|загрязненный, грязный, бесчестный
drawn|нарисованный
consult|советоваться
ladder|лестница
defense|оборона
sincere|искренний
trace|следить, чертить
track|след, тропа, колея
accord|согласие, гармония
pang|острая боль
pane|оконное стекло
forty|сорок
pant|задыхаться
joyful|радостный, довольный
foggy|туманный
school|школа, обучать
gaunt|Изможденный
monks|Монахи
mighty|могущественный
relic|след, остаток, пережиток
praise|хвалить
halt|остановка, останавливать
peacock|павлин
forth|вперед, впредь, далее
shell|раковина, скорлупа
spotted|Определенный
numeric|Числовой
examine|рассматривать, рассмотреть
relay|смена
test|анализ, проверка, испытывать
relax|ослаблять
excuse|извинять
artful|хитрый, ловкий
insist|настаивать
pluck|ощипывать, выщипывать, рвать
whether|ли
city|город
course|курс, блюдо
expect|ожидать
open|открывать
airport|аэропорт
are|есть
page|страница
arc|дуга
shelf|полка
essay|очерк
margin|минимум, нижняя грань, предел
refused|отказался
arm|рука
horace|Хорас
brutal|грубый, жестокий
plus|плюс
fork|вилка
form|бланк, форма, формировать
art|искусство
prepare|готовить
asa|Аса
fort|Форт
easel|мольберт
yawn|зевать, зевота
plum|слива
present|настоящее время, подарок, настоящий, присутствующий
harden|твердеть
ash|ясень
plug|пробка
nicest|самый вкусный
adults|взрослые
ask|просить, спрашивать
exams|экзамены
harder|больше, упорнее
picnic|пикник
haze|легкий туман
pair|пара
ship|корабль, пароход, грузить, перевозить
neglect|пренебрегать
pain|боль, страдание
finally|в конце концов
pail|ведро
contact|устанавливать связь
delight|восхищение, восхищаться
mode|способ
typical|типичный
paid|платил, оплаченный
fiery|Пламенный
spit|плеваться, фыркать
wasted|Потраченный впустую
engage|нанимать, занимать, вовлекать
ape|обезьяна
outrage|нарушение закона, насилие, оскорблять
loft|сеновал, чердак
mended|починил, починенный
money|деньги
spin|прясть, крутить
litter|мусор, сорить
fore|передний
ford|брод, переходить вброд
thomas|Томас
acquire|приобретать
delve|впадина, рытвина
app|Приложение
hum|жужжать, гудеть
spear|дротик, копье
mock|насмехаться
walked|гулял
apt|подходящий, уместный, склонный
apiece|за штуку, поштучно
hut|хижина
logs|Бревна
signed|Подписанный
pyramid|пирамида
mayor|мэр
speak|говорить, убеждать
haven|гавань, убежище
barton|имение, поместье, усадьба
frown|нахмуриться, недовольное выражение лица
sulky|мрачный, хмурый l
owen|Оуэн
should|следует
moaning|Стенание
scatter|разбрасывать, рассеивать
point|точка, пункт, суть дела, указывать, показывать
attach|придавать
attack|нападение, наступать
grimly|жестоко, решительно
shop|магазин, мастерская
pace|шагать
hate|ненавидеть
convict|признать виновным, осудить
foot|нога, фут
jersey|джемпер
bosom|грудь
infer|заключать, делать вывод
little|мало, маленький
show|показывать, демонстрировать, выставка, зрелище
pack|упаковывать, упаковать
alive|живой
shot|попытка, выстрел
fool|дурак, глупец
though|хотя, несмотря на
dismal|мрачный, унылый
rogue|плут, мошенник
butler|Дворецкий
hats|Шляпы
dismay|ужас
decoy|западня, приманка; заманивать в ловушку
combat|бой, борьба
yielded|Выданный
rings|Кольца
proper|правильный
shoe|ботинок, туфля
refusal|отказ
ave|прощание
systems|Системы
awe|страх
except|исключая, кроме
rouge|румяна, губная помада
nervous|нервный
rough|грубый
moan|оплакивать, стонать
fiend|дьявол, злой дух
food|пища
contain|содержать, сдерживать
bearer|носитель, податель, предъявитель
revenge|месть, мстить
reject|отвергать
yard|ярд, двор
athwart|через, вопреки
have|иметь, вспомогательный глагол
hanky|носовой платок
excess|избыток
tearing|Разрывание
ass|осел
object|возражать, предмет
mural|стенная живопись, фреска
unlucky|неудачный
push|толкать
beetle|трамбовать, дробить камни
fond|нежный
girl|девочка, девушка
fresh|свежий, бодрый
dyed|крашенный
ate|ел, съел
forms|формы
rightly|справедливо
fancied|Представлял себе
error|ошибка
folk|народная
urgent|крайне необходимый, срочный
lock|замок, запирать на замок
nearly|почти, приблизительно
learnt|узнал, выученный
refers|Обращается
fold|складывать, сгибать, скрещивать ; складка
nearest|ближайший
armour|броня
term|семестр, срок
mental|умственный
applied|прикладной
menace|опасность
secret|секрет
pushed|вытолкнутый
haul|тянуть
occur|случаться
hive|улей
trice|мгновение
placing|Размещение
angrily|сердито
chance|случай, шанс
olive|олива, маслина; оливкового цвета
furnish|снабжать, меблировать, обставлять
thanks|спасибо
roll|вращение, список, булочка, вращаться, катить
ceased|Прекратил
knock|стучать, стук
beans|фасоль
gloria|Глория
squall|писк, визг
role|роль
banquet|банкет
trick|хитрость, обман, обманывать
right|правильный, правый
bought|купил, купленный
inquire|спрашивать, узнавать
eighth|восьмой
crook|крюк, крючок, поворот
comic|кинокомедия, комический
canned|консервированный
rigid|жесткий
deadly|смертельно
sequel|продолжение, результат
partial|частичный
maria|Мария
few|мало
cleared|рассчитался
fee|гонорар, платить гонорар
caravan|фургон
fed|Кормивший
touch|соприкосновение, контакт
native|родной
washed|мыл, вымытый
multi|Много
cheque|банковский чек
attacks|Нападения
array|массив, множество, наряжать, украшать
enemies|Враги
naughty|непослушный
vivid|живой, яркий
made|делал, сделанный
net|сеть
visited|посетил
fantasy|воображение
daring|смелость, отвага; смелый, отважный
inquiry|расспросы, наведение справок
token|признак, примета
suburb|пригород, окраина
hiss|свистеть, шипеть, свист
hist|тише!, тс!
eighty|восемьдесят
usually|обычно, обыкновенно
mention|благодарность, упоминать
trial|попытка, испытание
ned|Нед
tragic|трагический
classes|занятия, уроки
purple|лиловый, малиновый
tribe|племя, клан
jazz|джаз
hazard|шанс, опасность
enjoy|любить, получать удовольствие
tasted|пробовал
new|новый
guess|отгадывать, догадка
beams|Лучи
hinge|петля, шарнир; висеть, вращаться на петлях
shorts|трусики
guest|гость
having|имеющий, обладающий
ballet|балет
tastes|имеет вкус
bullet|пуля
silas|Силас
root|корень
change|мелкие деньги, сдача, менять, пересаживаться
lead|вести, руководить
spoken|сказанный
leaf|лист
insects|Насекомые
jaws|Челюсти
pausing|Приостановка
capital|столица
surgery|хирургия, приемная хирурга
compact|компактный
march|маршировать
height|высота
medical|медицинский
rope|канат
nobles|Знать
marco|Марко
walrus|морж
popped|Совавший
lorry|грузовик
comma|запятая
execute|выполнять
lilac|сирень, сиреневый
watch|часы, cмотреть, наблюдать
wheels|Колеса
notable|заметный
fat|жирный
luck|удача, везение
canvas|холст, парус
far|далеко
lucy|Люси
display|показ, выставка
label|этикетка, приклеивать ярлык
rattle|трещать, греметь, грохотать; треск, грохот, погремушка, трещотка
fan|болельщик, поклонник
ajar|приоткрытый
borrow|брать в долг
roof|крыша
lean|прислоняться, наклоняться, наклон
fodder|фураж, корм
node|Узел
leak|просачиваться
often|часто
tough|жесткий
active|активный
make|делать, производить
leap|високосный, прыжок, прыгать
room|комната
sweater|эксплуататор
justice|справедливость
nan|Нэн
distant|дальний, далекий
tried|пытался
remarks|Замечания
through|через, сквозь
drawers|кальсоны
notably|исключительно
lavish|щедрый, обильный
trainer|тренер
gradual|постепенно
cottage|коттедж
nab|курок
asia|Азия
trained|обученный
classic|классический
mail|почта, отправлять
booking|продажа билетов
breeds|Породы
equal|равный
belfry|колокольня
main|главный
surgeon|хирург
rome|Рим
helping|помощь
freeze|замерзать
inside|внутрь, внутри
maid|горничная
venture|предприятие, риск
nat|Нат
castle|замок
dense|густой, плотный
nay|более того, даже; отрицательный ответ; отказ;
elated|окрыленный
circus|цирк, арена
brewing|затевающий, надвигающийся
diverse|разный, различный
deposit|взнос, вклад, залог, сдавать на хранение
puzzled|озадачен, поставлен в тупик
daisy|маргаритка
glow|сильный жар, накаляться
peered|Глядел
feral|Дикий
honey|мед
wilfrid|Вилфрид
slogan|лозунг
obvious|очевидный
rank|ряд, чин, выстраивать
errors|Ошибки
prickly|колючий
social|общественный
rang|звонил
asks|спрашивает
report|доклад, сообщать, рассказывать
empty|пустой
carrier|носильщик, транспортное средство
nations|Нации
rosy|розовый, румяный
hill|холм, гора
phantom|Фантом
dairy|молочный магазин
rose|роза
session|заседание
hoarse|хриплый
silence|молчание, тишина
needle|игла
bravery|храбрость, смелость
folding|складной
antique|древний
clamour|шум, крики
indeed|неужели, действительно
pebble|галька, горный хрусталь
europe|Европа
oxygen|кислород
finest|Самый прекрасный
broad|широкий
retired|отставной
rapt|восхищенный, похищенный
build|строить
dragged|Тянул
volcano|вулкан
riding|еду , верховая езда
adjust|регулировать, приспосабливать
built|строил, построенный
note|запись, записка, банкнота, записывать
crowded|многолюдный
water|вода, поливать, разбавлять
sickly|болезненный, нездоровый, тошнотворный
faith|вера
motley|разноцветный, пестрый
movie|кино, фильм
unknown|неизвестный
repose|полагаться, доверяться
diploma|диплом, свидетельство
fourth|четвертый
cigar|сигара
thinks|думает
omit|опускать, пропускать, упускать
club|клуб
clue|ключ , улика
square|площадь, квадратный
nose|нос
patch|заплатка
hike|путешествовать пешком
midst|середина
apply|обращаться, применять
envy|зависть, завидовать
marks|оценки
where|где, куда
fable|басня, сюжет
beast|зверь, животное
almost|почти, едва не
retreat|отступать, отступление, убежище
gentle|нежный, ласковый
rare|редкий, недожаренный
afresh|снова, опять
january|январь
wonder|удивляться
proceed|продолжать
action|действие, поступок
none|нисколько, совсем не, вовсе не
obscure|затемнять, затруднять понимание
workman|рабочий
clatter|стук, звон; стучать, греметь
mutton|баранина
hire|взять напрокат
eye|глаз
konrad|Конрад
jonas|Джонас
punch|пробивать , ударять кулаком, удар кулаком, пунш
blab|болтун, болтать
damage|повреждать, причинять ущерб
barbara|Барбара
console|утешать
forming|Формирование
restore|восстанавливать
dress|платье, одеваться
crushed|Сокрушенный
apple|яблоко
outwit|перехитрить
ferment|закваска, фермент; бродить
locks|Замки
rudder|руль
gently|мягко, кротко
penny|пенни
acting|временно исполняющий обязанности, игра
rainbow|радуга
lucidly|понятно, ясно
scale|масштаб
noon|полдень
aileen|Эйлин
proudly|гордо
circle|амфитеатр, круг
females|Женщины
sprung|Прыгал
unfair|несправедливый
guided|Управляемый
rate|тариф, расценка, степень, оценивать
paths|Дорожки
allows|Позволяет
below|ниже, внизу
lonely|одинокий
major|специализироваться, главный
pantry|кладовая, чулан
into|в
majesty|величественность, величество
problem|проблема
hint|намек, намекать
bottle|бутылка
daily|ежедневно
grammar|грамматика
luxury|роскошь
prank|проделка, разряжаться
anxious|беспокойный
remedy|лекарство
rash|стремительный, поспешный, опрометчивый; сыпь
bears|Медведи
tender|нежный
beard|борода
clothe|одевать
things|вещи, дела
spread|распространяться
gleam|проблеск, светиться
velvet|бархат, преимущество
timeout|Перерыв
bravely|смело
estate|поместье, имущество, сословие
faint|слабый
almond|миндаль, миндалина
limited|ограниченный
etc|И т.д
scar|шрам, рубец
ours|наш
blunt|притуплять
blew|дул
candle|свеча
hasten|торопить
yeah|да
hide|прятать, спрятать
solder|паять
richard|Ричард
bundle|узел, пакет
year|год
feature|особенность, характерная черта
selling|продажа
jake|Джейк
hairpin|шпилька
preview|предварительный просмотр
travels|Путешествия
bottom|дно, донышко
specify|точно определять, устанавливать, предписывать; детально излагать
dangers|Опасности
attic|чердак
admire|восхищаться
behave|вести себя
arduous|тяжелый, напряженный
glasses|очки
chase|охотиться, преследовать, погоня, охота
exposed|Выставленный
slower|медленнее
strike|ударять, забастовка
written|письменный, написанный
cringe|раболепствовать
furnace|печь, топка, горн
maud|Дорожный плед
dubious|сомнительный
annoy|досаждать, надоедать
citizen|гражданин
buffalo|буйвол
carter|возчик; ломовой извозчик
species|порода
delayed|отложен
mound|насыпь, холмик
liable|подлежащий, обязанный, ответственный
borne|ограниченный, с узким кругозором, узколобый, закостенелый
wolves|Волки
jail|тюрьма
young|молодой
admit|допускать
alter|изменять
charm|очарование
sticky|липкий, клейкий
picked|собранный, выбранный
narrow|узкий
mount|взбираться
thirsty|испытывающий жажду
sticks|Палки
basket|корзина
nut|орех
hick|провинциал, деревенщина
equally|поровну, одинаково, в равной степени
quickly|быстро
garden|сад
mate|товарищ
reflect|отражать, размышлять
arise|возникать, появляться
fairy|волшебный
glue|клей; клеить, приклеивать
perform|делать, выполнять
parsley|петрушка
parting|прощание
lantern|фонарь
adopted|Принятый
germany|Германия
glitter|блеск, блестеть
misery|страдания, нищета
vest|жилет , майка
china|фарфор
unhappy|несчастный, неудачный
eugene|Юджин
ranch|ранчо
orange|апельсин, оранжевый
enabled|Позволил
sniffed|Фыркал
mouth|рот
ducks|Утки
forest|лес
youth|молодежь
tactics|тактика
stared|пристальный
chalk|мел
syntax|Синтаксис
awhile|некоторое время
eggs|яйца
ceiling|потолок
several|несколько
freely|свободно
bingo|Лото
scarf|шарф
scare|испуг
reopen|возобновлять
quarter|четверть, квартал
uproar|шум, волнение
legal|законный
valid|правильный
powers|Полномочия
famous|известный
mouse|мышь
ere|До, перед, прежде чем; скорее чем
socks|носки
cloak|плащ, камера хранения
era|эра
romance|романтика, романтическая история
revive|оживать
leaving|уезжающий
child|ребенок
dirty|грязный
unusual|необычный
yours|ваш, ваши, твой, твои
granite|гранит
slang|жаргон
unleash|развязывать
slant|наклонный
mourn|сетовать
chill|холод, простуда
adult|взрослый
eliza|Элиза
general|общий
myth|миф
attire|украшение, наряд
effect|действие, влияние
ferry|перевоз
device|прибор, схема, проект, прием, устройство
err|Допустить ошибку
pretend|притворяться, делать вид
scan|Просмотр
parlour|кабинет
spurt|бить струей, делать внезапное усилие
high|высокий
lodge|разместить
very|очень, тот самый
surface|поверхность
mortal|смертный, смертельный
archie|Арчи
stare|пристальный взгляд
towards|к, в направлении
snigger|хихикать, хихиканье
info|Информация
mill|фабрика, завод, мельница
sheriff|Шериф
milk|молоко
mile|миля
mild|мягкий
arrived|приехал, прибыл
elf|Эльф
inga|Инга
nod|кивать головой, кивок
spruce|Ель
singing|Пение
mane|грива
cubic|кубический
random|случайный, беспорядочный
slammed|Хлопнул
again|снова
teeth|зубы
non|не
dusty|пыльный
not|не
many|много
solid|твердый
bubble|пузырь
nor|и не, также не
start|начинать, отправляться
now|сейчас
jungle|джунгли
prize|приз
saving|экономия
myself|себя, меня самого, себе, сам
strict|точный
shield|щит
oxbow|ярмо
mama|Мама
cells|Ячейки
range|ряд, линия, диапазон
valley|долина
dared|осмелившийся
escape|избежать, избегать
foolish|глупый
blanket|одеяло
robbery|грабеж
towers|Башни
upset|беспорядок, расстройство, расстроенный
genuine|подлинный
casual|случайный
mine|мой
patsy|Паци
mind|память, мнение, помнить, возражать
watcher|сторож, наблюдатель
tuesday|вторник
watches|часы
end|конец
options|Выбора
slowly|медленно
readily|охотно
shudder|дрожь, вздрагивать; содрогаться
vent|выпускать, испускать
male|мужчина, самец
mutter|бормотать
mint|мята
tackle|хватать
already|уже
anvil|наковальня
hauled|Буксируемый
blush|краснеть; краска стыда, смущения
keeper|хранитель, смотритель, сторож
process|процесс
really|на самом деле, действительно
darcy|Дарси
chair|стул
broadly|широко
beggar|нищий
chain|цепь
shuffle|шаркать
bloody|кровавый
reading|чтение
procure|доставать, добывать
elevate|поднимать, возвышать
italian|Итальянец
belong|принадлежать
furry|пушистый
decline|опускаться, уменьшаться, убывать
arched|Арочный
courage|мужество, смелость
mask|маска
beach|пляж
skip|пропускать (часто бывает при устано
egg|яйцо
skin|кожа
skim|просматривать, скользить
shrubs|кусты
pincers|клещи, щипцы
mass|масса, множество
scripts|Подлинники
mast|мачта
vaguely|Неопределенно
varnish|лак, лоск, лакировать
parties|вечеринки
dearest|Дорогой
organs|Органы
tenth|десятый
chief|шеф, начальник
acquit|оправдывать
forests|Леса
onward|вперед, далее, продвигающийся вперед
dream|мечтать, видеть сны
coward|трус
mark|норма, состояние, оценка, отметка
comer|приходящий
ninth|девятый
yell|пронзительный крик, кричать, вопить
crimson|алый, малиновый
thick|толстый, густой
senior|старший
decide|решать
blot|клякса, пятно, промокать
slave|раб
issue|выпуск, издание, выпускать
thrash|молотить, бить
state|государство, состояние
achieve|достигать, успешно выполнять
irene|Ирэн
veil|завеса, покрывало
quench|утолять
vein|вена, жила, жилка
because|потому что
wow|Ничего себе
landing|высадка на берег
designs|Проекты
quote|цитировать
leader|глава, лидер
won|победил, побежденный
ripen|зреть, созревать
plunder|добыча, грабить
blow|дуть
flatter|льстить
sternly|строго
minutes|минуты
inch|дюйм
vision|зрение, видение
tense|время
painful|причиняющий боль, мучительный
oranges|апельсины
lobster|омар
gates|стойки
decimal|десятичный, десятичная дробь
egypt|Египет
labour|труд, трудиться
amuse|забавлять, развлекать
blob|капля, комочек
ruffle|ерошить
beside|рядом, около
enlarge|увеличивать, расширять, распространяться l
address|адрес, обращение
bushes|кусты
vinegar|уксус
costume|костюм
thief|вор
special|специальный, особенный
turkey|индейка
nip|укус, щипать, пересечь
downy|пушистый
miss|промах, промахнуться, пропустить, скучать
mist|дымка
total|сумма, весь, полный
need|нуждаться в, надо, нужда, потребность
using|пользование
arch|арка, дуга
benefit|благо, польза
fish|рыба
higher|выше
captive|пленный
missing|недостающий, отсутствующий, пропавший
over|через, над, сверх
free|свободный
search|искать, обыскивать, поиск, обыск
oven|печь
snare|ловушка
flannel|фланель
trifle|пустяк
blacken|чернить, чернеть
snarl|рычать, огрызаться; рычание, ворчание
once|один раз, однажды
graze|задевать, оцарапать, содрать
parent|родитель, родственник
number|номер
attract|привлекать
apart|в стороне, отдельно
smoke|курить, курение, дым
uttered|Произнесенный
doubted|Подвергнутый сомнению
editor|редактор
marvel|удивляться, поражаться
salmon|лосось
fist|кулак
dainty|лакомство, деликатес
letters|письма
carrot|морковь
before|перед, до того как
screw|привинчивать, завинчивать, принуждать, винт
cereals|хлебные злаки, зерновые
mockery|издевательство
oil|масло
trouble|неприятность, беда, беспокоить, волноваться
stake|ставка, делать ставку
could|мог, могли
wet|мокрый
swamp|болото, топь
crashed|Потерпел крах
sand|песок
stair|лестница
sang|пел, спел
vapour|пар, пары
anxiety|тревога, беспокойство
firm|фирма, твердый, твердо, крепко
wrath|гнев, ярость
web|ткань, лента, перемычка
desired|Желательный
living|средства к существованию, жизнь
hermit|отшельник
stain|пятно, пятнать, пачкать
sank|тонул
fire|огонь, пожар
louder|громче
inland|внутренний
altered|Измененный
cobbler|сапожник
wealthy|богатый
clever|умный
fray|шумная ссора, обтрепываться
railing|ограда, перила
behalf|Защита
breed|порода
lecture|лекция
stall|партер
losing|проигрыш, проигранный
same|тот же, так же
taste|пробовать, иметь вкус
heron|цапля
who|кто
doctor|доктор, врач
close|закрывать
pause|пауза
slight|проявление пренебрежительного равнодушия;неуважение, пренебрежение, игнорирование
poll|подсчет , голосование; голосовать, подсчитывать голоса
pole|полюс
affairs|делишки
passage|проход
opinion|мнение
beagle|Гончая
proved|Доказанный
think|думать, мыслить
claims|Требования
winding|изгиб
get|получать, доставать, достигать, добраться
postal|почтовый
apology|извинение
grave|могила, серьезный, важный
sale|распродажа
cough|кашель
duchess|герцогиня
near|близко от, около
neat|чистый, опрятный
poke|толчок, тыкать
gravy|подливка, соус
stalk|стебель
icebox|холодильник
example|пример, образец
odd|странный
gem|драгоценный камень
veal|телятина
stale|черствый, затхлый
byword|поговорка, олицетворение
thing|вещь, предмет
salt|соль, соленый, солить
pound|фунт, фунт стерлингов
neck|шея
sake|ради, для
abate|уменьшить
today|сегодня, теперь, современный
retire|уходить, удаляться, оставлять должность
former|бывший
emma|Эмма
fits|подходит
throw|бросать
england|Англия
area|площадь, район
style|стиль, фасон, прическа
wit|ум, остроумие, остроумный человек, остряк
formed|сформировавшийся, организованный
golan|Голанский
types|Типы
pond|пруд
stamp|марка, печать, штемпелевать
wig|парик
five|пять
alluded|Ссылался
throb|пульсация, пульсировать
still|все еще, однако, тихий
win|выигрывать, побеждать
roast|жареный
capable|способный
persons|Люди
goats|Козлы
message|сообщение, поручение
stand|остановка, позиция, стенд, киоск, стоять, останавливаться
mission|миссия
off|прочь, от
arrival|прибытие
provoke|вызывать, провоцировать
hateful|ненавистный
visits|Посещения
odour|запах, аромат
why|почему
stomach|живот, желудок
sorrow|печаль
bands|ансамбли
curl|виться, завивать; локон, завиток
curb|сдерживать
court|корт, двор
receipt|квитанция
french|французский
impose|налагать
cure|лекарство, лечить
break|ломать
martial|военный
emerald|изумруд
bread|хлеб
pending|во время, в течение
only|только, единственный
import|импорт, ввоз
central|центральный
curt|краткий, сжатый, грубый
betty|Бетти
knife|нож
screen|экран, перегородка, прикрывать
ring|кольцо, звон, звонок, звенеть, звонить
fetch|приносить
heart|сердце
gag|затычка, кляп
welfare|благосостояние
loving|любящий
museum|музей
third|третий
detest|питать отвращение, ненавидеть
morrow|завтра, завтрашний день; следующий день
novelty|новизна, новинка
include|включать
upright|прямой, вертикальный, честный, справедливый
prime|главный
gas|газ
haughty|высокомерный, надменный
traffic|уличное движение
sitting|заседание
gay|веселый
poster|плакат
flurry|будоражить
bondage|рабство, зависимость
bandy|перебрасываться, хоккей, клюшка
abandon|отказываться, покидать, прекращать
rind|кожура, кора, корка
filch|Украсть
novel|роман
unseen|Невидимый
gap|брешь
beastly|противный
glossy|глянцевитый, блестящий
moment|момент, миг
talent|талант
arid|сухой, засушливый
sermon|проповедь
closet|чулан
protect|защищать, предохранять
cute|изящный, прелестный
icicle|сосулька
recover|выздоравливать
dizzy|головокружительный
heard|слушал, услышанный
scuffle|драка, потасовка
jackson|Джэксон
oak|дуб
indians|Индусы
dollar|доллар
closed|закрыл, закрытый
similar|похожий
files|Файлы
quicker|быстрее
clock|часы
mumble|бормотание
trout|форель
oar|весло
sparrow|воробей
differ|различать
flight|полет
kettle|чайник
ripe|спелый
falcon|сокол
healthy|здоровый
choked|Забитый
masses|Массы
save|спасать, хранить, экономить
count|считать, принимать во внимание
remains|Остается
fragile|хрупкий
arbour|беседка, дерево, ось
nursery|детский, ясли
niece|племянница
subtle|тонкий, неуловимый
prior|прежний
refuge|убежище
buffer|Буфер
mice|мыши
squeeze|выжимать, сжимать, давить, впихивать, сжатие, давка
flint|Кремень
torture|пытать, пытка
biology|биология
fling|бросать
musical|музыкальный, мюзикл
revolve|вращаться
enamel|эмаль, глазурь
issued|Выпущенный
liked|нравился, любил
ammonia|аммиак
heavy|тяжелый
machine|машина
dusk|сумеречный, неясный, сумерки
copies|Копии
clench|сжимать
pizza|пицца
operate|действовать
dust|пыль, вытирать пыль
issues|Проблемы
called|звонил, названный
stiff|негнущийся, застывший, холодный, натянутый
stack|стог, куча, груда
oars|вёсла
comics|комиксы
cotton|хлопок, хлопчатобумажный
wan|бледный, изнуренный
stick|палка, приставать
frog|лягушка
earnest|серьезный
wax|воск, восковой
way|дорога, путь, способ
from|от, из
durable|прочный
believe|верить
stage|сцена, эстрада, ставить
hurried|спешил, торопился
war|война, воевать
network|сеть
was|был
risk|риск, рисковать
army|армия
staff|штат, персонал, штаб
mould|плесень; плесенный грибок
poet|поэт
duty|долг, обязанность, пошлина
linger|медлить, задерживаться
rise|подниматься, восходить, подъем, повышение
able|способный
seaweed|Морская водоросль
driver|водитель, шофер
arms|оружие
prevail|торжествовать
swarm|рой, толпа; роиться, толпиться
poem|стихотворение, поэма
receive|получать
between|между
morton|Мортон
jessie|Джесси
susan|Сьюзен
hover|парить, вертеться
growing|растущий
oath|клятва, присяга
nancy|Нэнси
intent|намерение, цель
print|печатать, напечатать
aroused|разбуженный
geoff|Джеф
arson|поджог
mason|каменщик
wag|махать, трясти
renting|аренда, снятие комнаты
nell|Нелл
intend|намереваться
wad|прокладывать
found|нашел, найденный
juicy|сочный, дождливый
handle|обращаться с, управлять
wood|лес, древесина, дрова
arts|Искусства
arrow|стрела
sleigh|сани, салазки
rage|гнев, ярость
assure|уверять, обеспечивать
herring|сельдь
scrub|тереть
pride|гордость
danger|опасность
forward|передовой, вперед, впредь
juice|сок
wool|шерсть
dying|погибающий
pounce|налетать
serve|служить, обслуживать, подавать
bella|Белла
defined|Определенный
honor|Честь
kitchen|кухня
declare|декларировать
price|цена
supper|ужин
owl|сова
coming|приход, приходящий
warmth|тепло, теплота, сердечность
split|раскалывать
own|иметь, владеть, свой, собственный
face|лицо
wheel|колесо
pounds|фунты
stayed|остался
next|следующий, соседний, затем, потом
bucket|ведро
belly|живот, аппетит
cheaply|дешево, легко
survive|пережить
molly|Молли
lapse|описка
happy|счастливый
motor|мотор
possess|обладать
fur|мех, шкура
ruins|Руины
caught|ловил
notice|извещение, сообщение, замечать, обращать внимание
hair|волосы
kitty|цель
resent|обижаться, возмущаться
hail|приветствовать
fade|увядать
rift|трещина, щель, ущелье
news|новости, известия
snack|закуска, часть, доля
angle|угол, точка зрения
fact|сущность, факт
gladly|С удовольствием
ginny|Гинни
prompt|проворный, быстрый
raft|плот
agree|соглашаться
breadth|ширина, полотнище
faces|выходит, стоит лицом
dreams|мечты
dreamt|мечтал
inner|внутренний
minor|младший, незначительный, второстепенный
seize|хватать -e
rake|грабли, сгребать
ransom|выкуп, выкупать
marsh|болото
watery|водянистый, дождевой, бесцветный
alley|аллея, переулок
muddy|грязный, мутный
allen|Аллен
morsel|кусочек -l
woke|будил
bakery|пекарня
varying|Изменение
fallen|упавший
duke|герцог
marry|жениться, выходить замуж
charges|издержки, расходы
index|индекс, указатель, показатель
rotten|гнилой, отвратительный
victim|жертва
dispute|диспут, полемика, обсуждать
coffee|кофе
billion|биллион, миллиард
poison|яд, отравлять
fun|шутка, веселье
shiver|дрожать, дрожь, трепет
size|размер, величина, измерить
angel|ангел
glacier|ледник, глетчер
inform|сообщать
anger|гнев, злость
weeping|Плач e
vicious|порочный
shutter|ставень, затвор
darker|Более темный
beehive|улей
require|требовать
foreign|иностранный
killing|убийственный
devoted|преданный
result|результат
raid|нападение
dump|разгружать
tube|труба
well|хорошо, очень, добро, здоровый
compass|объем, диапазон; компас; циркуль
owe|быть должным
impulse|побуждение, порыв
knight|рыцарь
dumb|немой, бессловесный, бестолковый
neatly|аккуратно
dangle|качаться, подвешивать
rail|рельс
supply|снабжать
droop|поникать
rain|дождь
animal|животное
unite|соединять
clip|стричь, обрезать, зажимать
consent|разрешение
dull|скучный
cups|чашки
nest|гнездо
duly|должным образом
whistle|свист, свистеть
units|единицы
resume|итог, сводка, возобновлять, подводить итог
fro|обратно
yoke|иго, ярмо
squad|команда
wolf|волк
unity|единство
farther|дальше
views|Представления
grain|зерно
drops|Снижения
server|Прислуга
rapture|восторг, восхищение
harvest|урожай
fry|жарить
our|наш
out|вне, вон, из, снаружи, наружный
waste|тратить, использованный, негодный
flash|вспышка, сверкать
flask|фляжка
marble|мрамор
via|через
cursor|Курсор
fox|лиса
for|для, за, на
sober|трезвый
hundred|сто
angry|сердитый
falling|падение
vexed|сердил, раздражал
went|шел, ехал
jenny|Дженни
whence|Откуда
authors|Авторы
cover|покрывало, крышка
uneasy|встревоженный, неловкий
fail|недоставать, не хватать;  обмануть ожидания
file|картотека
opt|выбирать
groups|Группы
grasp|понять, схватить
glad|рад
grass|трава
preach|проповедовать
cricket|крикет
hideous|безобразный, уродливый, страшный
compare|сравнивать
guilty|виноватый
table|стол, таблица, расписание
create|создавать
fair|любезно, хорошо, справедливый
hunger|голод
locked|запертый
dreary|мрачный, унылый, скучный
flare|вспыхивать; вспышка, осветительная ракета
evil|зло, злой
rapidly|быстро
bruise|ушибать, синяк, ушиб
pressed|поглаженный, сжатый
warmly|тепло (-- как?
query|вопрос, спрашивать
ardour|жар, пыл, рвение
ground|земля
wept|Плакал
trying|ищу
cargo|груз
wanted|хотел, желанный
minds|ум
daytime|дневное время
pollen|Пыльца
grate|каминная решетка
cloth|ткань
dates|даты
judge|судья
union|союз
compile|составлять
highly|очень, весьма
weapons|Оружие
pockets|карманы
fake|подделка
stolen|украденный
united|объединенный
desert|пустыня
miracle|чудо
fairfax|Фаирфакс
crystal|хрусталь
saint|святой
visitor|гость
utterly|совершенно
quest|поиски
cares|заботится, переживает
snake|змея
article|статья, предмет, изделие
fog|туман
fall|падать
foe|враг
amends|возмещение
cloud|облако
clearly|ясно
wander|бродить, блуждать
lump|глыба, ком
old|старый
grant|дарить, дар
rack|полка для багажа над сиденьем
fried|жареный
fortune|удача, счастье
twinkle|мерцать, сверкать, мигать, мелькать
race|раса, гонка
fame|слава, известность
silly|глупый
were|были
please|пожалуйста
grand|величественный
humour|юмор, настроение
three|три
duck|утка
pleased|довольный
cards|карточки
work|работать, делать, работа, труд
worm|червь, глист, ничтожество
flank|фланг
worn|потёртый, изношенный
dialect|Диалект
letter|письмо
albert|Альберт
flu|грипп
pacific|мирный
tune|мотив
cattle|скот
colours|цвета
heavily|тяжело
threw|бросал
cuff|наручники, лёгкий удар
clerk|чиновник
fang|клык, корень зуба, зубец
fly|летать
program|программа
company|компания, общество
stitch|стежок, петля , шить
word|слово, обещание
even|даже
wore|носил, изнашивал
brush|щетка, чистить щеткой
palace|дворец
passing|прохождение
west|запад
skilful|квалифицированный, умелый, ловкий
ever|когда-либо
ride|езда, прогулка
clay|глина, земля
dancing|танцы
firing|Увольнение
allow|разрешать, разрешить
caution|осторожность
fig|Рис.
alloy|примесь, сплав
pepper|перец
fin|плавник
luke|Лук
recent|недавний
fir|пихта, ель
flame|пламя
minute|минута
brute|зверь, скотина
fit|подходить, соответствовать, устраивать
officer|служащий, офицер
dipper|черпак, ковш
fix|починить, наладить, назначить
notify|извещать, уведомлять
dues|сборы, взносы
perfect|совершенный
passion|страсть
fine|прекрасно, прекрасный
find|найти, находить
vow|обет, клятва
wheat|пшеница
film|фотопленка, фильм
profit|прибыль
rice|рис
rick|стог, складывать в стог
rich|богатый
marmot|сурок
fill|заполнить, наполнить
glanced|Поглядел
wishing|Пожелание
genus|Род
cherry|вишня
safety|безопасность
outer|внешний
savage|дикарь
cinema|кино
engaged|занятый, помолвленный
confuse|смущать, приводить в замешательство
clap|хлопать, аплодировать; удар, хлопок -p
nieces|Племянницы
assume|принимать на себя
claw|коготь, клешня
channel|канал
atlas|атлас
robots|Роботы
periods|Периоды
ralph|Ральф
folly|глупость
yuri|Юрий
reprove|порицать, делать выговор
horn|рог, забодать
brushed|Чистил
float|плавать, поплавок
parade|парад
hose|чулки
time|время
married|женатый, замужняя
barn|амбар
refer|отсылать, ссылаться
bark|кора дерева
woken|разбуженный
thereby|таким образом
dorothy|Дороти
minded|Склонный
bare|голый, бедный, простой
opened|открыл, открытый
thunder|гром, греметь
meddle|вмешиваться
host|хозяин
notion|понятие
mansion|дворец
maths|математика
shown|Показанным
isobel|Исобел
wide|широкий
neutral|нейтральный
alec|Алек
worship|поклоняться
tail|конец, хвост
clung|Цеплялся
extract|удалять, извлекать; экстракт, выдержка
pocket|карман
bite|кусаться
lined|Выровненный
prefix|префикс, приставка
wealth|богатство
herself|себя
uncle|дядя
linen|белье
vex|раздражать, сердить
queer|странный, эксцентричный
smooth|гладкий
queen|королева
depart|отбывать, уезжать
butcher|мясник
chiefly|главным образом
beware|осторожно
namely|а именно
partly|частично
patient|пациент, терпеливый
scenes|сцены, эпизоды
bath|ванна
carla|Карла
madly|безумно
lived|жил, живший
recoil|отдача, отпрянуть, испытывать ужас
ensure|обеспечивать, гарантировать
fritter|пончик, крошить
member|член
lizard|ящерица
waver|колебаться, быть в нерешительности
bars|Бруски
buttons|Кнопки
hour|час
meaning|значение
till|до
nerve|нерв
edible|съедобный
bird|птица
utility|полезность, выгодность, удобства, коммунальные услуги
incur|подвергаться
waved|Махал
elegant|изящный
comfort|удобство, утешение, утешать
bass|бас, басовый
arouse|будить, пробуждать
tile|черепица, кафель
breeder|производитель
base|основа
aunt|тетя
public|общественный
client|клиент
ditch|канава
qualify|квалифицировать
kate|Кейт
bounce|отскакивать
fate|судьба
faucet|водопроводный кран, вентиль
cock|петух, задирать
kiss|целовать
thimble|наперсток, наконечник
band|лента, оркестр, ансамбль
grapes|виноград
bank|банк
overall|всеобщий
tank|танк, резервуар
devote|посвящать
hood|капюшон, капор, колпак, крышка
trains|поезда
bang|ударять, хлопать
hoof|копыто
dad|папа, отец
hook|крючок
vital|жизненный, крайне необходимый
flames|Огонь
motive|повод, мотив
hoop|обруч
code|код
creak|скрип, скрипеть
jessamy|Джессами
cream|сливки, крем
tame|приручать, приручить, прирученный
bounds|граница, ограничение
careers|профессии
rising|возрастающий
dan|Дэн
rebuff|неудача, отпор
dam|дамба, плотина
day|день
prefer|предпочитать
fast|спешащий, сильно, быстро
large|большой
hope|надеяться
van|фургон, багажный вагон
guffaw|хохот
bill|счет, законопроект
emperor|император
powder|пудра
boldly|Смело
blaze|пламя, пылать, гореть
surly|угрюмый, неприветливый r
drinks|напитки
flock|стадо, стая
creator|творец, создатель, автор
feeble|слабый, бледный
lad|мальчик, юноша, парень
farm|ферма
lights|фары
author|автор
ally|союзник, соединять
gallant|доблестный, отважный, смелый, храбрый
ache|боль
tale|повесть, сказка, история
coal|уголь
implied|подразумеваемый
lap|подол
offset|смещенный
tall|невероятный, высокий
coat|пальто
talk|говорить, беседовать
law|закон, право
coax|уговаривать, задабривать
april|апрель
lay|класть, положить
amiable|любезный, милый
cable|кабельный
planned|плановый
photo|фотография
obliged|обязан, признателен
acorn|желудь
folks|Люди
great|великий
source|источник
acid|кислый, кислота
widen|расширять
take|брать, взять, принимать
bind|связывать
cup|чашка
aloft|наверху, наверх
peanut|земляной орех
reason|причина, довод, разум, рассудок
scotch|надрез, метка, уничтожать
poetry|поэзия, стихи
cub|детеныш
hatred|ненависть
stroke|удар, гладить t
convey|перевозить, передавать, сообщать
unwise|неразумный
given|данный
shops|магазины
byte|Байт
respond|отвечать
sixth|шестой
refresh|освежать
carry|нести, носить, возить
holes|Отверстия
wild|исступленный, безумный
reproof|порицание, выговор
busts|Бюсты
sixty|шестьдесят
hold|держать, выдерживать, захват, владение
privacy|уединенность
kazan|Казань
bewail|оплакивать, скорбеть
openly|открыто
eagerly|охотно
sights|достопримечательности
shoot|стрелять, застрелить
amusing|забавный, интересный
creep|ползать, выползать
will|вспомогательный глагол будущего времени
ought|долженствование
auto|автомобиль
holds|Держится
shook|трёс
heading|заголовок
apron|фартук
virtual|фактический
shore|берег
pardon|извинение
getting|передвижение
home|дом
sultry|знойный, душный
bigger|Больший
empire|империя, господство
dungeon|Темница
tape|лента, обматывать лентой
holy|священный, святой
quit|прекращать
short|короткий, слабый, внезапно
clear|ясный, светлый, очищать, расплатиться
thank|благодарить
hols|каникулы, отпуск
clean|чистить, чистый
quiz|опрос, проверять знания
waiter|официант
baffle|озадачивать, мешать
fertile|плодородный
portion|часть, доля
hole|отверстие, яма
restart|Переначало
dozen|дюжина
greek|Грек
green|зеленый
guinea|гинея
waited|ждал
robot|Робот
greet|приветствовать
anomaly|аномалия
master|хозяин
outcry|крик, протест
stroll|прогулка, гулять
famine|голод
pupil|ученик
hollow|пустой
method|метод
cut|разрез, фасон
settle|поселять, устраивать, оплачивать
devour|пожирать
closing|заключительный
stated|зафиксированный, высказанный, изложенный Заявленный
follows|Следует
segment|Доля
nylon|нейлон, нейлоновый
snap|щелкать
defect|недостаток, недочет
yacht|яхта
dragon|дракон
intense|интенсивный, напряженный
ranger|скиталец
honest|честный
carve|вырезать, отрезать
exert|напрягать
postage|почтовые расходы
fires|Огни
smear|масляное пятно, пачкать, мазать
oyster|устрица
foreman|мастер, старший рабочий, техник, прораб
family|семья
request|просьба
useful|полезный
socket|патрон , глазная впадина
cocoon|кокон
millet|просо, пшено
loyal|верный, лояльный
asking|спрашивающий, просящий
minus|минус
consist|состоять
assist|помочь, помогать
tire|уставать, надоесть
depth|глубина
kidding|шутящий, высмеивающий
arrive|приезжать
winter|зима
panic|паника
strong|сильный
flood|наводнение
liver|печень
invade|вторгаться
neville|Невилл
stiffen|деревенеть
tiny|крошечный
rabbit|кролик
panel|комиссия
defeat|поражение
explore|исследовать
lydia|Лидия
trailer|прицеп к автомобилю
grudge|завидовать, жалеть
feeding|питание
writing|письменность
sparkle|сверкать, искриться
shove|толкать, пихать, толчок
wrestle|бороться
seal|печать, запечатывать
seam|шов
affray|пугать
bits|куски
potion|Микстура
leaflet|Рекламный листок
conjure|показывать фокусы
alibis|Алиби
rabbits|Кролики
task|задача
boxes|ложи
dentist|зубной врач
motel|мотель, гостиница
wife|жена
prayers|Просьбы
tips|Наконечники
curved|Изогнутый
also|тоже, также
shout|кричать, крик
teddy|Тэдди
robes|Одежды
cope|справиться, совладать
yellow|желтый
manage|справляться, ухитряться, управлять
garbage|мусор
hearth|печь, камин, домашний очаг
hung|вешал, был склонным
verdure|зелень d
hairy|волосатый
recruit|вербовать, нанимать
evident|очевидный, ясный
ivan|Иван
seat|место, сиденье, сажать, усаживать
scowled|Хмурился
beset|окружать
hairs|Волосы
adopt|принимать, присваивать
hunt|охотиться
lovely|прекрасный, восхитительный
along|вдоль
alone|один, одинокий
hearty|искренний, сердечный, радушный
bureau|бюро, контора
copy|копия, копировать
fickle|непостоянный, изменчивый
cool|прохладный, холодный
cook|готовить, повар
waiting|ждать
pudding|пудинг
always|всегда
log|бревно
tangle|сплетение, путаница, запутывать
hamper|препятствие
inward|внутрь
jill|Джилл
sunday|воскресенье
swear|клясться
los|Лос
blade|лезвие
lot|много
packet|пакет
sniff|фыркать, сопеть
low|низкий
sweat|пот, потеть
startle|испугать, сильно удивить
nicer|лучше
ugly|уродливый
graphic|графический, наглядный, образный
taxi|такси
acts|Действия
rowing|гребля, выговор
strode|походка, большой шаг
drunk|выпитый, пьяный
use|использовать, употребить, польза, применение
states|Государства
adorn|украшать
cone|конус, шишка
letting|Разрешение
captain|капитан
duster|тряпка, щетка
sinking|погружение
kalgan|Калган
kingdom|королевство
decree|декрет, указ; издавать декрет; постановлять
publish|публиковать
baby|ребенок
license|давать разрешение
crept|ползал
renewed|Возобновленный
holder|владелец, ручка, рукоятка
stagger|шатание, шатать
seed|семя, семена
plumage|Оперение
quay|набережная
come|приходить, приезжать
back|спина, назад
seen|увиденный
comb|гребенка, расчесывать, расчесать
seem|казаться
seek|искать
fitting|примерка
handful|горсть
talking|беседа
either|или
feeling|чувство, чувствующий
south|юг
defend|защищать, оборонять
cousins|кузены
actress|актриса
adore|обожать
con|Подставить
col|Седло
nerves|нервы
sports|спорт, спортивные соревнования
cow|корова
faded|Исчез
ended|Законченный
science|наука, умение
valuer|оценщик
robin|малиновка
values|Ценности
comply|уступать, соглашаться
lunch|второй завтрак, обед
valued|Оцененный
vessel|сосуд, судно
tells|Сообщает
select|выбирать, сортировать, избранный
prudent|осторожный, благоразумный
cavity|впадина, полость
period|период
darwin|Дарвин
cost|стоить, стоил
sweep|мести
render|отдавать
urn|урна
planets|Планеты
failure|неудача
sweet|милый, сладкий, приятный
cosy|уютный
battle|бой, сражение
joseph|Джозеф
kennel|конура, собачий питомник
sound|звук, звучать, играть
whom|кому, кого
crest|гребешок, хохолок, гребень
english|английский язык, английский
shaped|Форменный
berries|ягоды
cork|поплавок
ditty|песенка
corn|кукуруза
troop|войска
setting|окружение
traitor|изменник, предатель
pirate|пират
blake|Блак
thrust|толчок, удар, толкать
thus|так, таким образом
regular|регулярный
chasing|уклоняющийся
camera|фотоаппарат
cabinet|кабинет
gasped|Задыхался
sacred|священный
natives|Аборигены
cry|кричать, восклицать
exploit|эксплуатировать
owing|должный
unit|единица
hump|горб
usage|употребление, обычай
potato|картофель
core|сущность, суть
cord|шнур
renewal|обновление
monkey|обезьяна
person|человек, особа, лицо, личность
assign|назначать
ties|связи
house|дом
modest|скромный
avoid|избегать, избежать
tree|дерево
briefly|кратко, сжато
income|доход, заработок
pour|лить
bandage|бинт, повязка, перевязывать, бинтовать
nights|ночи
focus|фокусировать
loyalty|верность
heels|пятки
blame|считать виноватым, вина, упрек, порицание
stopper|пробка, затычка
million|миллион
tidy|чистый, аккуратный, убирать, приводить в порядок
tiring|утомительный
extra|сверх
goat|козел, коза
hours|часы
greedy|жадный
slender|тонкий, стройный
cushion|подушка
scrap|клочок, кусочек, отрывок
blinked|Мигал
trek|поход, переход
goal|цель, гол
curtain|занавеска, занавес
hugo|Хьюго
huge|огромный
bait|приманка
stopped|остановились
funeral|похороны, похоронный
indices|Индексы
jolly|очень, веселый
bail|поручительство
glove|перчатка
utilize|использовать
tied|связанный
dislike|нелюбовь, неприязнь; не любить
topmost|самый верхний, самый важный
port|порт
prayer|молитва, просьба
bytes|Байты
lovers|Любители
souls|Души
remove|удалять, убирать, перемещать
funnel|воронка, труба
jumble|толкаться
beheld|Созерцал
secure|страховать
self|сам, себя
fairly|довольно
furrow|борозда, колея
mirror|зеркало
modern|современный
pose|поза, ставить
sell|продавать, торговать
tide|прилив и отлив
aloud|громко, вслух
ball|мяч
module|Модуль
post|почта, после
anthony|Энтони
blank|пустой, чистый
cache|Тайник
let|позволять, давать, разрешать
whilst|Пока
return|вернуть, возвращение
semi|Полу
bald|лысый, оголенный
stored|Запасенный
elinor|Элеонор
folder|папка
leg|нога
russia|Россия
prison|тюрьма
lee|Защита
storey|этаж
nickel|никл
radio|радио
glowing|Пылающий l
pots|Горшки
hedwig|Хедвиг
folded|складчатый
pigeons|Голуби
phone|телефон
send|отправлять, посылать
undo|развязывать, расстегивать
alas|Увы
ghosts|Призраки
enable|давать возможность, делать возможным
remote|дистанционный, удаленный
drawer|чертежник
explode|взрывать, подрывать
skull|череп
sent|отправил, послал, отправленный, посланный
swell|отличный, превосходный
bade|Предлагал
cold|холод, холодный
nurse|няня
niche|ниша
grieved|Огорченный
deceive|обманывать
goes|идет
genius|гений
loudly|громко
status|статус
regards|привет, поклон
tram|трамвай
howl|выть, вой
plunge|нырять
chose|выбирал, выбрал
trap|ловушка, западня
stable|конюшня
seized|захваченный
junior|младший
statue|статуя, памятник
barren|бесплодный, неплодородный
formal|официальный, формальный
injured|поврежденный
season|время года, сезон, созревать
tray|поднос
pork|свинина
ducked|Увернулся
suite|номер люкс
match|спичка, матч
output|выпуск, продукция
barrel|баррель
pore|пора
lastly|Наконец
pony|пони
blast|взрыв, взрывать, разрушать
madam|госпожа
protest|протестовать, протест
convert|превращать, обращать, конвертировать
inflict|наносить удар
seaside|морское побережье
purpose|цель
casks|Бочки
affair|дело, занятие
pool|пруд, бассейн
bananas|бананы
bonnet|капор, дамская шляпа
couple|пара
blocked|Блокированный
mossy|мшистый
invite|приглашать
lit|освещённый
detect|открывать, обнаруживать
seasick|страдающий морской болезнью
spiders|Пауки
lip|губа
coin|монета
crooked|кривой
poor|бедный
aerial|воздушный, антенна
around|вокруг, по
lid|крышка
starter|стартер
chances|Возможности
instead|вместо, взамен
coil|виток, катушка
snowman|снежная баба
first|первый
bags|сумки, багаж
lie|ложь, лгать, лежать
stormy|бурный
causing|Порождение
berth|койка, спальное место
ebb|отлив, убывать
lawn|лужайка
threat|угроза
beamed|Сиял
until|до
triumph|триумф
trot|рысь, рысца, бежать рысью
parcel|пакет
thread|нитка
boring|скучный
laws|Законы
spider|паук
brow|бровь
fishy|подозрительный, сомнительный
slow|медленный, замедлять
frantic|неистовый c
licence|лицензия, разрешение
torch|факел
sleek|гладкий, приглаживать
effects|Эффекты
sleep|спать, сон
amid|между, посреди, среди
header|Удар головой
fetched|принесённый, достанный
fowls|Домашние птицы
buzzer|гудок
ear|ухо
gaily|весело, оживленно (g
slumber|сон, дремота, дремать
sneeze|чихать, чиханье
eat|есть
review|обзор, смотр
seated|Помещенный
peak|вершина
wrist|наручный, запястье
leave|оставлять, покидать, уезжать
mad|обезумевший
write|писать, записывать
debate|дебаты, спор, полемика
map|карта
evening|вечер
man|мужчина, человек
vernon|Вернон
spirits|души
may|май
mat|коврик
limbs|конечности
equator|экватор
starts|Запуски
what|что, какой
allied|союзный, родственный
gums|десны
volume|объем, громкость
exists|Существует
squint|косоглазие, косить
peal|трезвон, раскат грома
dining|обеденный
lazy|ленивый
reeds|Тростники
peas|горошек, горох
pear|груша
arable|пахотный
studio|студия
careful|осторожный
least|наименьший, менее всего
spite|злость
abroad|за границей
aware|сознающий
balance|равновесие
pasture|пастбище
conduct|вести, руководитель, проводить
would|вспомогательный, модальный глагол
unlike|непохожий
hostess|хозяйка
future|будущее
crevice|трещина, расщелина
gloom|мрак, уныние
seldom|редко
cement|цемент, основа
forced|принудительный, принужденный
depths|Глубины
gust|порыв
bishop|епископ, слон
reward|награда
saucer|блюдце
begins|начинается
superb|превосходный
learn|узнать, учиться
burst|заливаться, разражаться
zigzag|Зигзаг
wring|скручивать, выжимать
bedroom|спальня
starve|умирать от голода
leash|поводок, цепь
lease|аренда, сдавать в аренду
laughed|смеялся, хохотал
doing|делающий
bonus|премия
dread|страшиться, страх
mobile|подвижный
harold|Гарольд
trusted|Доверял
meg|Мэг
sadness|печаль
dealing|раздачаv
brooch|брошь
poking|Тыкание
chosen|выбранный
adapt|приспособить, переделать
madeira|Мадейра
swimmer|пловец
island|остров
sister|сестра
met|встречались, встреченный
knocked|стучать
swim|плавать
lofty|высокий, возвышенный
trip|поездка, экскурсия
men|мужчины
trim|подрезка, стрижка
swig|потягивать вино
sketch|эскиз
uniform|форма, форменная одежда
leapt|прыгал
makes|делает
ahead|вперед
glory|слава
maker|производитель
upward|направленный вверх
plunged|Погруженный
elbow|локоть
meeting|встреча
venus|Венера
nobody|никто
dye|красить, краска
street|улица
rested|отдыхал
barrier|барьер, преграда
ticket|билет
repay|оплачивать
whip|кнут, хлыст, хлестать, сечь, взбивать
fully|вполне, полностью
limit|предел, граница
gene|ген
ladies|дамы
parrots|Попугаи
toast|тост , сушить
reality|действительность
monthly|месячный, ежемесячно
flew|летал
flee|бежать
biting|острый, резкий b
fled|убегал, спасался бегством
flea|блоха
county|графство
mildred|Милдред
weird|судьба, рок, таинственный, странный
series|серия
breeze|легкий ветер
fashion|мода
numb|онемелый, оцепенелый
beaming|Сияющий
hastily|поспешно, опрометчиво
eleven|одиннадцать
wound|рана
across|через
chicken|цыпленок, кура
solve|решать
cobweb|паутина
harmony|гармония, согласованность
trapes|Западни
null|Пустой указатель
banner|знамя
lion|лев
parlor|Комната
schemes|Схемы
british|британский
dollars|доллары
ideal|идеал, идеальный
true|правильный, верный
harshly|грубо, резко
outcome|результат
lark|жаворонок
amorous|влюбленный, любовный
grains|Зерно s
lard|топленое свиное сало
insert|вставлять, помещать
dismiss|увольнять
confide|доверять, полагаться, признаваться
spike|острие
realize|представлять себе, реализовать
atom|атом
cliffs|Утесы
last|прошлый, последний, продолжаться, длиться
arcadia|Аркадия
terror|ужас
being|будучи
carpet|ковер, устилать
fever|жар, лихорадка
fraud|обман, фальшивка
gull|чайка
poems|стихи
when|когда
phrase|фраза
gulf|залив, бухта
peck|клевать
lash|хлестать, ударять; плеть
credit|кредит
grounds|Основания
homes|дома
live|жить
flaw|изъян, недостаток
flax|лен, льняное полотно
peter|Питер
flat|квартира, плоский
germ|зародыш , микроб
spill|проливать
flap|развеваться, взмахивать , клапан
inherit|наследовать
balloon|воздушный шар
plucky|смелый, отважный
pious|набожный
flag|флаг
liquid|жидкость
late|поздно
tub|кадка, лохань, ушат
runners|Бегуны
eastern|восточный
lawyer|адвокат, юрист
virtue|добродетель
brakes|тормоза
gravity|серьезность
tickle|щекотать
jack|домкрат
highway|большая дорога, шоссе
copper|медь
fitness|годность
fanny|Фанни
muffler|шарф
beauty|красота, косметический
improve|улучшать
father|папа
burly|крепкий
extent|протяжение
mineral|минeральный
illness|болезнь
suspect|подозревать
sexual|сексуальный
muffled|закутанный, укутанный, завёрнутый
hush|водворять тишину
peel|чистить, почистить
fright|испуг
lining|подкладка
peer|вглядываться, всматриваться
edmund|Эдмунд
spine|позвоночный столб
peep|проблеск, выглядывать
besides|кроме, кроме того
extend|продлевать, растягивать
silver|серебро, серебряный
shelves|Полки
gets|действует
list|список
section|отделение, делить на части
human|человеческий
two|два
easter|пасха
hurt|рана, болеть, причинить боль, повредить
absorb|поглощать, всасывать, впитывать
suited|Удовлетворенный
mummy|Мумия
hotel|гостиница
summary|конспект, суммарный
slab|плита
corners|Углы
chatter|болтать, болтовня
dot|точка
ragged|истрепанный, оборванный, рваный
dos|ДОС
gutter|водосточный желоб, канава
strange|странный
nature|природа
compose|сочинять, составлять
humor|юмор
cordial|сердечный
option|выбор
contend|бороться, соперничать
books|книги
going|идущий
trend|общее направление, тенденция
mob|толпа, сборище
cell|камера, ячейка
windows|окна
mop|швабра, подтирать
pedal|педаль
content|содержание
urged|Побуждённый, подстёгнутый
mow|косить
floor|пол, этаж; одолеть, смутить
simply|просто, абсолютно
leading|лидирование, руководящий
chorus|хор
shaving|бритье
elastic|эластичный, упругий, резинка
shade|оттенок, тень, затенять
exam|экзамен
try|пробовать, пытаться
assumed|Принятый
shrewd|проницательный, ловкий
wildly|Дико
silent|молчаливый, бесшумный
frank|искренний, откровенный, открытый
currant|коринка, смородина
simple|простой, однозначный
data|данные, факты
calmly|тихо, спокойно
date|дата
stooped|Наклоненный
spring|весна
witness|свидетель
risen|Повышенный
leads|Лидерство
widow|вдова
numbers|Номера
shady|тенистый, сомнительный, темный
reply|отвечать, ответ
reverse|противоположное, обратное
payment|плата
flora|Флора
bradley|Брадлей
nuts|орехи
grocer|бакалейщик
wallace|Уоллис
cannot|не уметь
shaft|древко, ручка, рукоятка, вал
employ|держать на работе, нанимать
replace|заменять, замещать
slap|хлопать
franz|Франз
dash|оттолкнуть, отбросить
expense|расход
pattern|модель
judged|Оцененный
laid|происходил, совершался
edward|Эдвард
dog|собака
confirm|подтверждать, утверждать
invited|пригласил, приглашенный
respect|уважение, уважать
slam|хлопать, хлопнуть -m
asleep|спящий
kenneth|Кеннет
essence|сущность
kick|пинать, пнуть
provide|обеспечивать
attend|посещать, обслуживать
centre|центр -re
pushing|Подталкивание
happily|счастливо
harsh|грубый, резкий
mug|кружка
rueful|унылый
mud|грязь
student|студент
busily|Деловито
hoax|разыгрывать
darn|штопать
dark|темный, печальный
swallow|глотать, проглатывать
login|Логин
dare|сметь, отважиться
follow|следовать
however|однако
width|ширина
shone|сиял, блестел
lake|озеро
kids|дети
emerge|появляться, выясняться, возникать
chalked|Рисовавший мелом
logic|логика
ensued|Последовал
weigh|взвешивать, весить
reader|читатель
frame|оправа, рамка
widely|широко
nodding|Кивающий
repel|отталкивать, внушать отвращение
due|должный, обязанный
dug|сиська, вымя
clumsy|неуклюжий
paddle|короткое весло, грести одним веслом; шлепать по воде
liquor|крепкий спиртной напиток
toe|палец
weight|вес, тяжесть, груз
spree|веселье, шалость
sudden|внезапный
rocky|скалистый
catch|уловить, понять, получить нагоняй
land|земля, суша, приземляться, высаживаться на берег
turtle|Черепаха
lane|дорожка
destroy|разрушать, уничтожать
toy|игрушка, играть, забавляться
tow|буксировать, тянуть, тащить
servers|Прислуга
fifteen|пятнадцать
ton|тонна
ivory|слоновая кость
too|слишком, тоже
globe|земной шар, глобус
top|верх, верхушка
cent|цент
emerged|Появился
larva|личинка, головастик
dry|сухой
bred|Разводимый
muscle|мышца
lamb|ягненок, баранина
lame|хромой
snatch|схватить
months|месяцы
cadence|ритм, интонация
ernie|Ерни
flour|мука
mature|зрелый, созреть
inches|Дюймы
lamp|лампа
certain|определенный, некоторый, некий
success|успех, удача
shift|смена, перемещать
shaggy|лохматый
poultry|домашняя птица
garlic|чеснок
tie|связь, связывать, галстук
shake|пожать , дрожать, трясти
rescue|спасение, спасать
guests|гости
shine|сиять, светить
excite|возбуждать, волновать
tin|олово, жестянка, консервная банка
insect|насекомое
tim|Тим
tip|чаевые, давать на "чай", наконечник
center|центр
thy|Ваш
slim|стройный
vacant|свободный, незанятый
damp|сырой, влажный
behold|Созерцать
brew|затевать, надвигаться
burden|груз, бремя
ethel|Етел
propose|предлагать
initial|начальный, первоначальный
undergo|испытывать, подвергаться
slid|скользить
armed|вооруженный
flower|цветок
shiny|Солнечный
frankly|откровенно
dame|дама, пожилая женщина
piano|пианино
alert|бдительный, проворный
awkward|неуклюжий
did|делал, действовал
bargain|сделка
gnaw|грызть, глодать
without|без
ascent|восхождение, подъем
quietly|тихо, спокойно
booth|кабинка
exit|выход, выезд
shall|модальный глагол долженствования
largest|Самый большой
tempt|искушать
record|запись, пластинка, отчет, рекорд
fence|забор
obtain|добиваться
anyhow|во всяком случае
cakes|пироги
wizards|Волшебники
tired|усталый
reserve|заказывать
divided|Разделенный
david|Дэвид
boost|повышение, повышать
flavour|вкус, аромат
frail|хрупкий, хилый
cross|пересекать
smell|запах
shame|стыд, стыдить, стыдиться
cabin|каюта
might|можно, возможно
des|Дес
diary|дневник
attest|удостоверять
dew|роса
launch|начинать
contest|спор, соревнование, спорить
munch|чавкать
king|король
kind|добрый, вид, род
version|версия
private|частный
bedding|спальные принадлежности
bike|велосипед
command|приказ, управлять, приказывать
booty|награбленное добро, добыча
smelt|плавить
rustle|шелест, шорох, шелестеть, шуршать
den|берлога, притон
boots|ботинки, сапоги
trigger|курок
shells|Снаряды
spray|брызги, обрызгивать
figured|Изображенный
brim|край, поля
speaker|оратор
slip|скольжение, скользить -p
flakes|хлопья
gloves|перчатки
awake|бодрствующий
darling|любимый, дорогой
mix|смешивать, мешать
plates|тарелки
mutual|взаимный, общий
spirit|дух
mid|средний
ten|десять
kill|убивать
justly|справедливо
haunted|Часто посещаемый
tea|чай, отвар
charity|милосердие
impact|удар
ted|раскидывать
cannon|пушка, орудие
gear|механизм
woman|женщина
pets|домашние животные
cooling|охлаждение
power|держава, энергия, сила, мощность
tack|линия, курс
repair|ремонтировать, ремонт, починка
adrift|по течению, по воле волн
shirt|рубашка, блузка
shoes|обувь, туфли
lace|кружево, шнурок
breathe|дышать
symbol|символ
eyebrow|бровь
diana|Диана
shape|форма
lack|недостаток
tread|ступать, наступать
himself|себя, себе, сам
default|Неплатеж, невыполнение обязательств
market|рынок
await|ждать
pest|паразит, вредитель, бич
hunting|охота
sobbing|Рыдание
perhaps|возможно, может быть
filter|фильтр; фильтровать, просачиваться
treat|удовольствие, лечить, относиться
other|другой
crown|корона
sandy|песчаный
hatchet|топор
dim|тусклый, неясный, слабый , туманный, смутный
din|шум, долбить
share|разделять, доля, часть
dip|погружать
order|порядок, приказ, заказ, заказывать, приказывать
elbows|Локти
die|штамповать, чеканить
dig|копать
jelly|желе
crowd|толпа, толпиться
skinny|худой, тощий, кожа да кости
balcony|балкон
nostril|ноздря
enemy|враг, противник
sharp|точно, ровно, резкий, крутой, плутовать
justin|Джастин
origin|происхождение
the|определенный артикль
shark|акула
women|женщины
shock|удар
bertram|Бертрам
ending|окончание, завершение
bronze|бронзовый
blonde|блондин
hedge|ограда
massive|массивный
sway|качание, взмах
keyhole|замочная скважина
petrol|бензин
lads|парни
largely|обильно
swam|плавал
context|контекст, ситуация
swan|лебедь
summer|лето, летний
cluster|гроздь; скопляться, тесниться
forgery|подделка, подлог
lady|дама, госпожа
culprit|обвиняемый, преступник
claimed|Требуемый
rivulet|ручеек, речушка
